output	target
<CLS><CLS>C1C1(CCC2C1(CCC3C1CCC4C3(CCC5(C4)CO4)C)C)O<SEP>CCCCCCCCCCCCCCCCCCCCCCCCCCCCCCCCCCCCCCCCCCCCCCCCCCCCCCC	<CLS>CCCC1(CCC2C1(CCC3C2CCC4C3(CCC5(C4)CO5)C)C)O<SEP><PAD><PAD><PAD><PAD><PAD><PAD><PAD><PAD><PAD><PAD><PAD><PAD><PAD><PAD><PAD><PAD><PAD><PAD><PAD><PAD><PAD><PAD><PAD><PAD><PAD><PAD><PAD><PAD><PAD><PAD><PAD><PAD><PAD><PAD><PAD><PAD><PAD><PAD><PAD><PAD><PAD><PAD><PAD><PAD><PAD><PAD><PAD><PAD><PAD><PAD><PAD><PAD><PAD><PAD><PAD>
<CLS>CCOC1=C(C=CC(=C1)C=C(C#N)C2=CC=CC=C2Cl)OCC3=CC(=CC=C3)F<SEP>CCCCCCCCCCCCCCCCCCCCCCCCCCCCCCCCCCCCCCCCCCC	<CLS>CCOC1=C(C=CC(=C1)C=C(C#N)C2=CC=CC=C2Cl)OCC3=CC(=CC=C3)F<SEP><PAD><PAD><PAD><PAD><PAD><PAD><PAD><PAD><PAD><PAD><PAD><PAD><PAD><PAD><PAD><PAD><PAD><PAD><PAD><PAD><PAD><PAD><PAD><PAD><PAD><PAD><PAD><PAD><PAD><PAD><PAD><PAD><PAD><PAD><PAD><PAD><PAD><PAD><PAD><PAD><PAD><PAD><PAD>
<CLS>CCCOC1=CC=C(C=C1)C(=C2C(N(C(=O)C2=O)CCCN(C)C)C3=CC(=CC=C3)OCC4=CC=CC=C4)O<SEP>CCCCCCCCCCCCCCCCCCCCCCCCC	<CLS>CCCOC1=CC=C(C=C1)C(=C2C(N(C(=O)C2=O)CCCN(C)C)C3=CC(=CC=C3)OCC4=CC=CC=C4)O<SEP><PAD><PAD><PAD><PAD><PAD><PAD><PAD><PAD><PAD><PAD><PAD><PAD><PAD><PAD><PAD><PAD><PAD><PAD><PAD><PAD><PAD><PAD><PAD><PAD><PAD>
<CLS>CCC1=CC=C(C=C1)C(C(C)C)NS(=O)(=O)C2=CC3=C(C=C2)NC(=O)N3<SEP>CCCCCCCCCCCCCCCCCCCCCCCCCCCCCCCCCCCCCCCCCCC	<CLS>CCC1=CC=C(C=C1)C(C(C)C)NS(=O)(=O)C2=CC3=C(C=C2)NC(=O)N3<SEP><PAD><PAD><PAD><PAD><PAD><PAD><PAD><PAD><PAD><PAD><PAD><PAD><PAD><PAD><PAD><PAD><PAD><PAD><PAD><PAD><PAD><PAD><PAD><PAD><PAD><PAD><PAD><PAD><PAD><PAD><PAD><PAD><PAD><PAD><PAD><PAD><PAD><PAD><PAD><PAD><PAD><PAD><PAD>
<CLS>C1CCC2=C(C1)C(=C(S2)NC(=O)NC3=CC=CC4=CC=CC=C43)C(=O)N5CCOCC5<SEP>CCCCCCCCCCCCCCCCCCCCCCCCCCCCCCCCCCCCCC	<CLS>C1CCC2=C(C1)C(=C(S2)NC(=O)CC3=CC=CC4=CC=CC=C43)C(=O)N5CCOCC5<SEP><PAD><PAD><PAD><PAD><PAD><PAD><PAD><PAD><PAD><PAD><PAD><PAD><PAD><PAD><PAD><PAD><PAD><PAD><PAD><PAD><PAD><PAD><PAD><PAD><PAD><PAD><PAD><PAD><PAD><PAD><PAD><PAD><PAD><PAD><PAD><PAD><PAD><PAD>
<CLS>C1CCN(C1)C2=C(C=C(C=C2)CO)[N+](=O)[O-]<SEP>CCCCCCCCCCCCCCCCCCCCCCCCCCCCCCCCCCCCCCCCCCCCCCCCCCCCCCCCCCCC	<CLS>C1CCN(C1)C2=C(C=C(C=C2)CO)[N+](=O)[O-]<SEP><PAD><PAD><PAD><PAD><PAD><PAD><PAD><PAD><PAD><PAD><PAD><PAD><PAD><PAD><PAD><PAD><PAD><PAD><PAD><PAD><PAD><PAD><PAD><PAD><PAD><PAD><PAD><PAD><PAD><PAD><PAD><PAD><PAD><PAD><PAD><PAD><PAD><PAD><PAD><PAD><PAD><PAD><PAD><PAD><PAD><PAD><PAD><PAD><PAD><PAD><PAD><PAD><PAD><PAD><PAD><PAD><PAD><PAD><PAD><PAD>
<CLS>COC1=C(C(=C(C=C1)C=NNC(=O)CC2=CC=CC=C2[N+](=O)[O-])I)OCC=C<SEP>CCCCCCCCCCCCCCCCCCCCCCCCCCCCCCCCCCCCCCCC	<CLS>COC1=C(C(=CC(=C1)C=NNC(=O)CC2=CC=CC=C2[N+](=O)[O-])I)OCC=C<SEP><PAD><PAD><PAD><PAD><PAD><PAD><PAD><PAD><PAD><PAD><PAD><PAD><PAD><PAD><PAD><PAD><PAD><PAD><PAD><PAD><PAD><PAD><PAD><PAD><PAD><PAD><PAD><PAD><PAD><PAD><PAD><PAD><PAD><PAD><PAD><PAD><PAD><PAD><PAD><PAD>
<CLS>C1=CC=C(C=C1)C2=C(C(=O)N(N=C2C3=CC=CC=C3)CC4=CC=CC5=CC=CC=C54)C(=))O<SEP>CCCCCCCCCCCCCCCCCCCCCCCCCCCCCC	<CLS>C1=CC=C(C=C1)C2=C(C(=O)N(N=C2C3=CC=CC=C3)CC4=CC=CC5=CC=CC=C54)C(=O)O<SEP><PAD><PAD><PAD><PAD><PAD><PAD><PAD><PAD><PAD><PAD><PAD><PAD><PAD><PAD><PAD><PAD><PAD><PAD><PAD><PAD><PAD><PAD><PAD><PAD><PAD><PAD><PAD><PAD><PAD><PAD>
<CLS>CC1=CC(=C(C=C1)NC(=O)C2=CC=CC=C2N(C)C(=O)C3=CC=CS3)C<SEP>CCCCCCCCCCCCCCCCCCCCCCCCCCCCCCCCCCCCCCCCCCCCCC	<CLS>CC1=CC(=C(C=C1)NC(=O)C2=CC=CC=C2N(C)C(=O)C3=CC=CS3)F<SEP><PAD><PAD><PAD><PAD><PAD><PAD><PAD><PAD><PAD><PAD><PAD><PAD><PAD><PAD><PAD><PAD><PAD><PAD><PAD><PAD><PAD><PAD><PAD><PAD><PAD><PAD><PAD><PAD><PAD><PAD><PAD><PAD><PAD><PAD><PAD><PAD><PAD><PAD><PAD><PAD><PAD><PAD><PAD><PAD><PAD><PAD>
<CLS>CC(C(=O)NC1CC1)OC(=O)CCCNS(=O)(=O)C2=CC3=CC=CC=C3C=C2<SEP>CCCCCCCCCCCCCCCCCCCCCCCCCCCCCCCCCCCCCCCCCCCCC	<CLS>CC(C(=O)NC1CC1)OC(=O)CCCNS(=O)(=O)C2=CC3=CC=CC=C3C=C2<SEP><PAD><PAD><PAD><PAD><PAD><PAD><PAD><PAD><PAD><PAD><PAD><PAD><PAD><PAD><PAD><PAD><PAD><PAD><PAD><PAD><PAD><PAD><PAD><PAD><PAD><PAD><PAD><PAD><PAD><PAD><PAD><PAD><PAD><PAD><PAD><PAD><PAD><PAD><PAD><PAD><PAD><PAD><PAD><PAD><PAD>
<CLS>C1CCC(CC1)C2C3=NC=CN3C4=C(C(=N2)C5=CC=CC=C5)N=C(C=C4)Cl<SEP>CCCCCCCCCCCCCCCCCCCCCCCCCCCCCCCCCCCCCCCCCCC	<CLS>C1CCN(CC1)C2C3=NN=CN3C4=C(C(=N2)C5=CC=CC=C5)N=C(C=C4)Cl<SEP><PAD><PAD><PAD><PAD><PAD><PAD><PAD><PAD><PAD><PAD><PAD><PAD><PAD><PAD><PAD><PAD><PAD><PAD><PAD><PAD><PAD><PAD><PAD><PAD><PAD><PAD><PAD><PAD><PAD><PAD><PAD><PAD><PAD><PAD><PAD><PAD><PAD><PAD><PAD><PAD><PAD><PAD><PAD>
<CLS>CN1C(=O)C=C(C(=N1)C2=CC=CC=C2)Br<SEP>CCCCCCCCCCCCCCCCCCCCCCCCCCCCCCCCCCCCCCCCCCCCCCCCCCCCCCCCCCCCCCCCCC	<CLS>CN1C(=O)C=C(C(=N1)C2=CC=CC=C2)Br<SEP><PAD><PAD><PAD><PAD><PAD><PAD><PAD><PAD><PAD><PAD><PAD><PAD><PAD><PAD><PAD><PAD><PAD><PAD><PAD><PAD><PAD><PAD><PAD><PAD><PAD><PAD><PAD><PAD><PAD><PAD><PAD><PAD><PAD><PAD><PAD><PAD><PAD><PAD><PAD><PAD><PAD><PAD><PAD><PAD><PAD><PAD><PAD><PAD><PAD><PAD><PAD><PAD><PAD><PAD><PAD><PAD><PAD><PAD><PAD><PAD><PAD><PAD><PAD><PAD><PAD><PAD>
<CLS>C1=CC=C(C(=C1)C=NNC(=O)C(=O)NC2=CC=CC(=C2)C(F)(F)F)OC(=O)C3=CC=CC=C3[N+=(COC[O-]<SEP>CCCCCCCCCCCCCCCCCC	<CLS>C1=CC=C(C(=C1)C=NNC(=O)C(=O)NC2=CC=CC(=C2)C(F)(F)F)OC(=O)C3=CC=CC=C3[N+](=O)[O-]<SEP><PAD><PAD><PAD><PAD><PAD><PAD><PAD><PAD><PAD><PAD><PAD><PAD><PAD><PAD><PAD><PAD><PAD><PAD>
<CLS>CC1=C(C(=C(C(=N1)NC2=CC=CC(=C2)C(F)(F)F)C)NC)OC)[N+](=O)[O-]<SEP>CCCCCCCCCCCCCCCCCCCCCCCCCCCCCCCCCCCCCC	<CLS>CC1=C(C(=C(C(=N1)NC2=CC=CC(=C2)C(F)(F)F)C#N)COC)[N+](=O)[O-]<SEP><PAD><PAD><PAD><PAD><PAD><PAD><PAD><PAD><PAD><PAD><PAD><PAD><PAD><PAD><PAD><PAD><PAD><PAD><PAD><PAD><PAD><PAD><PAD><PAD><PAD><PAD><PAD><PAD><PAD><PAD><PAD><PAD><PAD><PAD><PAD><PAD><PAD><PAD>
<CLS>CC(C)CC(C(=O)O)NC(=O)C(CC1=CC=CC=C1)NC(=O)C(CN)NC(=O)C(NC(=O)NCC<SEP>CCCCCCCCCCCCCCCCCCCCCCCCCCCCCCCCCC	<CLS>CC(C)CC(C(=O)O)NC(=O)C(CC1=CC=CC=C1)NC(=O)C(CS)NC(=O)C(CC(=O)N)N<SEP><PAD><PAD><PAD><PAD><PAD><PAD><PAD><PAD><PAD><PAD><PAD><PAD><PAD><PAD><PAD><PAD><PAD><PAD><PAD><PAD><PAD><PAD><PAD><PAD><PAD><PAD><PAD><PAD><PAD><PAD><PAD><PAD><PAD><PAD>
<CLS>CCN1C(=C(C=N1)CNC(=O)C2=CC=C(O2)COC3=C(C=CC(=C3)[N+](=O)[O-])ClCC<SEP>CCCCCCCCCCCCCCCCCCCCCCCCCCCCCCCCC	<CLS>CCN1C(=C(C=N1)CNC(=O)C2=CC=C(O2)COC3=C(C=CC(=C3)[N+](=O)[O-])Cl)C<SEP><PAD><PAD><PAD><PAD><PAD><PAD><PAD><PAD><PAD><PAD><PAD><PAD><PAD><PAD><PAD><PAD><PAD><PAD><PAD><PAD><PAD><PAD><PAD><PAD><PAD><PAD><PAD><PAD><PAD><PAD><PAD><PAD><PAD>
<CLS>CC1=CC=CC=C1OCCC(=O)NC(C)C(=O)C2=C(C(=C(N2)C)C(=O)C)C<SEP>CCCCCCCCCCCCCCCCCCCCCCCCCCCCCCCCCCCCCCCCCCCCC	<CLS>CC1=CC=CC=C1OCCC(=O)OC(C)C(=O)C2=C(C(=C(N2)C)C(=O)C)C<SEP><PAD><PAD><PAD><PAD><PAD><PAD><PAD><PAD><PAD><PAD><PAD><PAD><PAD><PAD><PAD><PAD><PAD><PAD><PAD><PAD><PAD><PAD><PAD><PAD><PAD><PAD><PAD><PAD><PAD><PAD><PAD><PAD><PAD><PAD><PAD><PAD><PAD><PAD><PAD><PAD><PAD><PAD><PAD><PAD><PAD>
<CLS>C1CC(C(=O)NCC(=O)N(C(C(=O)NC(C(=O)N2C1)CC3=CC=C(C=C3)O)CCCN)C(=O)C(NC4=CC=CCCCC4)OCN<SEP>CCCCCCCCCCCCCC	<CLS>C1CC2C(=O)NCC(=O)N(C(C(=O)NC(C(=O)N2C1)CC3=CC=C(C=C3)O)CCCN)C(=O)C(CC4=CC=C(C=C4)O)N<SEP><PAD><PAD><PAD><PAD><PAD><PAD><PAD><PAD><PAD><PAD><PAD><PAD><PAD><PAD>
<CLS>CCC(C)C(C(=O)NCC(=O)NC(CC(=O)O)C(=O)NC(CCC(=O)N)C(=O)NC(CC1=CC=C(C=C2)O)C(=C)CC(C(CCCCC(=O)NC(CCCC<SEP>	<CLS>CCC(C)C(C(=O)NCC(=O)NC(CC(=O)O)C(=O)NC(CCC(=O)N)C(=O)NC(CC1=CC=C(C=C1)O)C(=O)NC(C(C)C)C(=O)NC(CCCC<SEP>
<CLS>CC(C1=CC=CC=C1)NC(=O)N2CCC(CC2)C(=O)NC3=CC=CC=C3<SEP>CCCCCCCCCCCCCCCCCCCCCCCCCCCCCCCCCCCCCCCCCCCCCCCCCC	<CLS>CC(C1=CC=CC=C1)NC(=O)N2CCC(CC2)C(=O)NC3=CC=CC=C3<SEP><PAD><PAD><PAD><PAD><PAD><PAD><PAD><PAD><PAD><PAD><PAD><PAD><PAD><PAD><PAD><PAD><PAD><PAD><PAD><PAD><PAD><PAD><PAD><PAD><PAD><PAD><PAD><PAD><PAD><PAD><PAD><PAD><PAD><PAD><PAD><PAD><PAD><PAD><PAD><PAD><PAD><PAD><PAD><PAD><PAD><PAD><PAD><PAD><PAD><PAD>
<CLS>C1=CC(=CC=C1CNC(=O)C2=C(C=C(C=C2)[N+](=O)[O-])[N+](=O)[O-])CNC(=O)C3=C(C=C(C=C3)[N+](=O)[--]))]+](<SEP>	<CLS>C1=CC(=CC=C1CNC(=O)C2=C(C=C(C=C2)[N+](=O)[O-])[N+](=O)[O-])CNC(=O)C3=C(C=C(C=C3)[N+](=O)[O-])[N+](<SEP>
<CLS>CC1=C(C(=O)C2=CC=CC=C2O1)CN3CCN(CC3)C4=CC=CC=C4.Cl<SEP>CCCCCCCCCCCCCCCCCCCCCCCCCCCCCCCCCCCCCCCCCCCCCCCC	<CLS>CC1=C(C(=O)C2=CC=CC=C2O1)CN3CCN(CC3)C4=CC=CC=N4.Cl<SEP><PAD><PAD><PAD><PAD><PAD><PAD><PAD><PAD><PAD><PAD><PAD><PAD><PAD><PAD><PAD><PAD><PAD><PAD><PAD><PAD><PAD><PAD><PAD><PAD><PAD><PAD><PAD><PAD><PAD><PAD><PAD><PAD><PAD><PAD><PAD><PAD><PAD><PAD><PAD><PAD><PAD><PAD><PAD><PAD><PAD><PAD><PAD><PAD>
<CLS>CC(C)(C)C1=CC=C(C=C1)C=C2C(=O)NC(=N2)C3=CC(=CC=C3)F<SEP>CCCCCCCCCCCCCCCCCCCCCCCCCCCCCCCCCCCCCCCCCCCCCCC	<CLS>CC(C)(C)C1=CC=C(C=C1)C=C2C(=O)OC(=N2)C3=CC(=CC=C3)F<SEP><PAD><PAD><PAD><PAD><PAD><PAD><PAD><PAD><PAD><PAD><PAD><PAD><PAD><PAD><PAD><PAD><PAD><PAD><PAD><PAD><PAD><PAD><PAD><PAD><PAD><PAD><PAD><PAD><PAD><PAD><PAD><PAD><PAD><PAD><PAD><PAD><PAD><PAD><PAD><PAD><PAD><PAD><PAD><PAD><PAD><PAD><PAD>
<CLS>COC1=C(C=CC(=C1)C(=O)NC2=CC(=C(C=C2)N3C(=O)C4=CC=CC=C4C3=O))C5=CC6=CC=C6C=C5)CC<SEP>CCCCCCCCCCCCCCCCCCC	<CLS>COC1=C(C=CC(=C1)C(=O)NC2=CC(=C(C=C2)N3C(=O)C4=CC=CC=C4C3=O)OC)OCC5=CC=C(C=C5)Cl<SEP><PAD><PAD><PAD><PAD><PAD><PAD><PAD><PAD><PAD><PAD><PAD><PAD><PAD><PAD><PAD><PAD><PAD><PAD><PAD>
<CLS>CC1=C(N(C2=C1C(=NC(=N2)C)CC)C3=C(C=C(C=C3)F)OC(F)(F)F)Br)C<SEP>CCCCCCCCCCCCCCCCCCCCCCCCCCCCCCCCCCCCCCCC	<CLS>CC1=C(N(C2=C1C(=NC(=N2)C)Cl)C3=C(C=C(C=C3Br)OC(F)(F)F)Br)C<SEP><PAD><PAD><PAD><PAD><PAD><PAD><PAD><PAD><PAD><PAD><PAD><PAD><PAD><PAD><PAD><PAD><PAD><PAD><PAD><PAD><PAD><PAD><PAD><PAD><PAD><PAD><PAD><PAD><PAD><PAD><PAD><PAD><PAD><PAD><PAD><PAD><PAD><PAD><PAD><PAD>
<CLS>CC(=O)NC1=CC=CC(=C1)NC(=O)C2=CC=CC=C2[N+](=O)[O-]<SEP>CCCCCCCCCCCCCCCCCCCCCCCCCCCCCCCCCCCCCCCCCCCCCCCCC	<CLS>CC(=O)OC1=CC=CC(=C1)NC(=O)C2=CC=CC=C2[N+](=O)[O-]<SEP><PAD><PAD><PAD><PAD><PAD><PAD><PAD><PAD><PAD><PAD><PAD><PAD><PAD><PAD><PAD><PAD><PAD><PAD><PAD><PAD><PAD><PAD><PAD><PAD><PAD><PAD><PAD><PAD><PAD><PAD><PAD><PAD><PAD><PAD><PAD><PAD><PAD><PAD><PAD><PAD><PAD><PAD><PAD><PAD><PAD><PAD><PAD><PAD><PAD>
<CLS>C1CCC2(C1)C(=O)N(C(=O)N2)CC(=O)N3CCN(CC3)CC4=CC=CC=C4<SEP>CCCCCCCCCCCCCCCCCCCCCCCCCCCCCCCCCCCCCCCCCCCCC	<CLS>C1CCC2(C1)C(=O)N(C(=O)N2)CC(=O)N3CCN(CC3)CC4=CC=CC=C4<SEP><PAD><PAD><PAD><PAD><PAD><PAD><PAD><PAD><PAD><PAD><PAD><PAD><PAD><PAD><PAD><PAD><PAD><PAD><PAD><PAD><PAD><PAD><PAD><PAD><PAD><PAD><PAD><PAD><PAD><PAD><PAD><PAD><PAD><PAD><PAD><PAD><PAD><PAD><PAD><PAD><PAD><PAD><PAD><PAD><PAD>
<CLS>CC1CC(CC1=O)CO<SEP>CCCCCCCCCCCCCCCCCCCCCCCCCCCCCCCCCCCCCCCCCCCCCCCCCCCCCCCCCCCCCCCCCCCCCCCCCCCCCCCCCCCC	<CLS>CC1(CNNC1=O)CO<SEP><PAD><PAD><PAD><PAD><PAD><PAD><PAD><PAD><PAD><PAD><PAD><PAD><PAD><PAD><PAD><PAD><PAD><PAD><PAD><PAD><PAD><PAD><PAD><PAD><PAD><PAD><PAD><PAD><PAD><PAD><PAD><PAD><PAD><PAD><PAD><PAD><PAD><PAD><PAD><PAD><PAD><PAD><PAD><PAD><PAD><PAD><PAD><PAD><PAD><PAD><PAD><PAD><PAD><PAD><PAD><PAD><PAD><PAD><PAD><PAD><PAD><PAD><PAD><PAD><PAD><PAD><PAD><PAD><PAD><PAD><PAD><PAD><PAD><PAD><PAD><PAD><PAD><PAD><PAD><PAD><PAD><PAD><PAD><PAD>
<CLS>COC1=CC=CC=C1S(=O)(=O)C2=C(SC(=C2)C(=S)N)Cr<SEP>CCCCCCCCCCCCCCCCCCCCCCCCCCCCCCCCCCCCCCCCCCCCCCCCCCCCCCC	<CLS>COC1=CC=CC=C1S(=O)(=O)C2=C(SC(=C2)C(=N)N)Br<SEP><PAD><PAD><PAD><PAD><PAD><PAD><PAD><PAD><PAD><PAD><PAD><PAD><PAD><PAD><PAD><PAD><PAD><PAD><PAD><PAD><PAD><PAD><PAD><PAD><PAD><PAD><PAD><PAD><PAD><PAD><PAD><PAD><PAD><PAD><PAD><PAD><PAD><PAD><PAD><PAD><PAD><PAD><PAD><PAD><PAD><PAD><PAD><PAD><PAD><PAD><PAD><PAD><PAD><PAD><PAD>
<CLS>CC1=CC(=O)OC2=C1C=CC(=C2)NC(=O)C3=NN(N=C3)COC4=C(C=C(C=C4)Cl)Cl<SEP>CCCCCCCCCCCCCCCCCCCCCCCCCCCCCCCCCCC	<CLS>CC1=CC(=O)OC2=C1C=CC(=C2)NC(=O)C3=NN(C=C3)COC4=C(C=C(C=C4)Cl)Cl<SEP><PAD><PAD><PAD><PAD><PAD><PAD><PAD><PAD><PAD><PAD><PAD><PAD><PAD><PAD><PAD><PAD><PAD><PAD><PAD><PAD><PAD><PAD><PAD><PAD><PAD><PAD><PAD><PAD><PAD><PAD><PAD><PAD><PAD><PAD><PAD>
<CLS>C1=CC=C2C(=C1)C(=CC=C2)CN<SEP>CCCCCCCCCCCCCCCCCCCCCCCCCCCCCCCCCCCCCCCCCCCCCCCCCCCCCCCCCCCCCCCCCCCCCCCCC	<CLS>C1=CC=C2C(=C1)C(=CC=C2I)N<SEP><PAD><PAD><PAD><PAD><PAD><PAD><PAD><PAD><PAD><PAD><PAD><PAD><PAD><PAD><PAD><PAD><PAD><PAD><PAD><PAD><PAD><PAD><PAD><PAD><PAD><PAD><PAD><PAD><PAD><PAD><PAD><PAD><PAD><PAD><PAD><PAD><PAD><PAD><PAD><PAD><PAD><PAD><PAD><PAD><PAD><PAD><PAD><PAD><PAD><PAD><PAD><PAD><PAD><PAD><PAD><PAD><PAD><PAD><PAD><PAD><PAD><PAD><PAD><PAD><PAD><PAD><PAD><PAD><PAD><PAD><PAD><PAD><PAD>
<CLS>CC1(C=CC2=C(C1)C3=C(C=CC4=CC=CC=C43)C5=C2C6CCC=C6)C<SEP>CCCCCCCCCCCCCCCCCCCCCCCCCCCCCCCCCCCCCCCCCCCCCCC	<CLS>CC1(C=CC2=C(O1)C3=C(C=CC4=CC=CC=C43)C5=C2C6CCC5C6)C<SEP><PAD><PAD><PAD><PAD><PAD><PAD><PAD><PAD><PAD><PAD><PAD><PAD><PAD><PAD><PAD><PAD><PAD><PAD><PAD><PAD><PAD><PAD><PAD><PAD><PAD><PAD><PAD><PAD><PAD><PAD><PAD><PAD><PAD><PAD><PAD><PAD><PAD><PAD><PAD><PAD><PAD><PAD><PAD><PAD><PAD><PAD><PAD>
<CLS>CC(C1=NC2=CC=CC=C2N1)NC(=O)CN3C=C(C=C(C3=O)Cl)C(F)(F)F<SEP>CCCCCCCCCCCCCCCCCCCCCCCCCCCCCCCCCCCCCCCCCCCC	<CLS>CC(C1=NC2=CC=CC=C2N1)NC(=O)CN3C=C(C=C(C3=O)Cl)C(F)(F)F<SEP><PAD><PAD><PAD><PAD><PAD><PAD><PAD><PAD><PAD><PAD><PAD><PAD><PAD><PAD><PAD><PAD><PAD><PAD><PAD><PAD><PAD><PAD><PAD><PAD><PAD><PAD><PAD><PAD><PAD><PAD><PAD><PAD><PAD><PAD><PAD><PAD><PAD><PAD><PAD><PAD><PAD><PAD><PAD><PAD>
<CLS>C1CN(C(CN1)C2=CC=C(C=C2)CCC3COC(N3)(=NC4=CC=C4)C5=C(C=C(C=C5)Cl)Cl)CCN<SEP>CCCCCCCCCCCCCCCCCCCCCCCCCCCC	<CLS>C1CN(C(CN1)C2=CC=C(C=C2)OCC3COC(O3)(CN4C=CN=C4)C5=C(C=C(C=C5)Cl)Cl)CCN<SEP><PAD><PAD><PAD><PAD><PAD><PAD><PAD><PAD><PAD><PAD><PAD><PAD><PAD><PAD><PAD><PAD><PAD><PAD><PAD><PAD><PAD><PAD><PAD><PAD><PAD><PAD><PAD><PAD>
<CLS>CC(C)C(C(C)C)NC(=O)C1=CC=C(C=C1)CN2CCCC2=O<SEP>CCCCCCCCCCCCCCCCCCCCCCCCCCCCCCCCCCCCCCCCCCCCCCCCCCCCCCCC	<CLS>CC(C)C(C(C)C)NC(=O)C1=CC=C(C=C1)CN2CCCC2=O<SEP><PAD><PAD><PAD><PAD><PAD><PAD><PAD><PAD><PAD><PAD><PAD><PAD><PAD><PAD><PAD><PAD><PAD><PAD><PAD><PAD><PAD><PAD><PAD><PAD><PAD><PAD><PAD><PAD><PAD><PAD><PAD><PAD><PAD><PAD><PAD><PAD><PAD><PAD><PAD><PAD><PAD><PAD><PAD><PAD><PAD><PAD><PAD><PAD><PAD><PAD><PAD><PAD><PAD><PAD><PAD><PAD>
<CLS>C1=CC(=CC=C1C2=NN(C(=O)O2)CC#CC)C(F)(F)F<SEP>CCCCCCCCCCCCCCCCCCCCCCCCCCCCCCCCCCCCCCCCCCCCCCCCCCCCCCCCCC	<CLS>C1=CC(=CC=C1C2=NN(C(=O)O2)CC#CI)C(F)(F)F<SEP><PAD><PAD><PAD><PAD><PAD><PAD><PAD><PAD><PAD><PAD><PAD><PAD><PAD><PAD><PAD><PAD><PAD><PAD><PAD><PAD><PAD><PAD><PAD><PAD><PAD><PAD><PAD><PAD><PAD><PAD><PAD><PAD><PAD><PAD><PAD><PAD><PAD><PAD><PAD><PAD><PAD><PAD><PAD><PAD><PAD><PAD><PAD><PAD><PAD><PAD><PAD><PAD><PAD><PAD><PAD><PAD><PAD><PAD>
<CLS>COC1=C(C(=C(C(=C1)C(=O)OCC(=O)C2=CC=C(C=C2)Cl)Br)OC)OC<SEP>CCCCCCCCCCCCCCCCCCCCCCCCCCCCCCCCCCCCCCCCCCCC	<CLS>COC1=C(C(=C(C(=C1)C(=O)OCC(=O)C2=CC=C(C=C2)Cl)Br)OC)OC<SEP><PAD><PAD><PAD><PAD><PAD><PAD><PAD><PAD><PAD><PAD><PAD><PAD><PAD><PAD><PAD><PAD><PAD><PAD><PAD><PAD><PAD><PAD><PAD><PAD><PAD><PAD><PAD><PAD><PAD><PAD><PAD><PAD><PAD><PAD><PAD><PAD><PAD><PAD><PAD><PAD><PAD><PAD><PAD><PAD>
<CLS>CC(C)C1=C(C=C2C(=C1)OCC3C2(CCCC3(C)C)C)NC(=O)CC4=CNC5=CC=CC=C54<SEP>CCCCCCCCCCCCCCCCCCCCCCCCCCCCCCCCCCC	<CLS>CC(C)C1=C(C=C2C(=C1)CCC3C2(CCCC3(C)C)C)OC(=O)CC4=CNC5=CC=CC=C54<SEP><PAD><PAD><PAD><PAD><PAD><PAD><PAD><PAD><PAD><PAD><PAD><PAD><PAD><PAD><PAD><PAD><PAD><PAD><PAD><PAD><PAD><PAD><PAD><PAD><PAD><PAD><PAD><PAD><PAD><PAD><PAD><PAD><PAD><PAD><PAD>
<CLS>C1CC[NH+](C1)CCCNC(=O)C=CC2=CC=CC=C2Cl)C3=CC=CS3.[Cl-]<SEP>CCCCCCCCCCCCCCCCCCCCCCCCCCCCCCCCCCCCCCCCCCCC	<CLS>C1CC[NH+](C1)C(CNC(=O)C=CC2=CC=CC=C2Cl)C3=CC=CO3.[Cl-]<SEP><PAD><PAD><PAD><PAD><PAD><PAD><PAD><PAD><PAD><PAD><PAD><PAD><PAD><PAD><PAD><PAD><PAD><PAD><PAD><PAD><PAD><PAD><PAD><PAD><PAD><PAD><PAD><PAD><PAD><PAD><PAD><PAD><PAD><PAD><PAD><PAD><PAD><PAD><PAD><PAD><PAD><PAD><PAD><PAD>
<CLS>CC1(OCC(O1)CCl)C2=CC=CC=C2<SEP>CCCCCCCCCCCCCCCCCCCCCCCCCCCCCCCCCCCCCCCCCCCCCCCCCCCCCCCCCCCCCCCCCCCCCCCC	<CLS>CC1(OCC(O1)CCl)C2=CC=CC=C2<SEP><PAD><PAD><PAD><PAD><PAD><PAD><PAD><PAD><PAD><PAD><PAD><PAD><PAD><PAD><PAD><PAD><PAD><PAD><PAD><PAD><PAD><PAD><PAD><PAD><PAD><PAD><PAD><PAD><PAD><PAD><PAD><PAD><PAD><PAD><PAD><PAD><PAD><PAD><PAD><PAD><PAD><PAD><PAD><PAD><PAD><PAD><PAD><PAD><PAD><PAD><PAD><PAD><PAD><PAD><PAD><PAD><PAD><PAD><PAD><PAD><PAD><PAD><PAD><PAD><PAD><PAD><PAD><PAD><PAD><PAD><PAD><PAD>
<CLS>CC1=CC(=CC=C1)C(=O)(=CC2=CC(=C(C=C2)OC)C)C3=C(C=C(C=C3Cl)Cl)Cl<SEP>CCCCCCCCCCCCCCCCCCCCCCCCCCCCCCCCCCCC	<CLS>CC1=CC(=CC=C1)C(=O)C=CC2=CC(=C(C=C2)OC)COC3=C(C=C(C=C3Cl)Cl)Cl<SEP><PAD><PAD><PAD><PAD><PAD><PAD><PAD><PAD><PAD><PAD><PAD><PAD><PAD><PAD><PAD><PAD><PAD><PAD><PAD><PAD><PAD><PAD><PAD><PAD><PAD><PAD><PAD><PAD><PAD><PAD><PAD><PAD><PAD><PAD><PAD><PAD>
<CLS>CC1=CC(=C(C=C1)OC)N2C(=O)C3=C(SC4=[N+]3CCCC4C5=CC(=CC(=C5)CCCCC(C2=OCC<SEP>CCCCCCCCCCCCCCCCCCCCCCCCCCCC	<CLS>CC1=CC(=C(C=C1)C)CN2C(=O)C3=C(NC4=[N+]3CCCN4C5=CC(=CC(=C5)C)C)N(C2=O)C<SEP><PAD><PAD><PAD><PAD><PAD><PAD><PAD><PAD><PAD><PAD><PAD><PAD><PAD><PAD><PAD><PAD><PAD><PAD><PAD><PAD><PAD><PAD><PAD><PAD><PAD><PAD><PAD><PAD>
<CLS>C(CCC(=O)O)C(Cl)(Cl)Cl)CCI<SEP>CCCCCCCCCCCCCCCCCCCCCCCCCCCCCCCCCCCCCCCCCCCCCCCCCCCCCCCCCCCCCCCCCCCCCCCC	<CLS>C(CCC(=O)OCC(Cl)(Cl)Cl)CCI<SEP><PAD><PAD><PAD><PAD><PAD><PAD><PAD><PAD><PAD><PAD><PAD><PAD><PAD><PAD><PAD><PAD><PAD><PAD><PAD><PAD><PAD><PAD><PAD><PAD><PAD><PAD><PAD><PAD><PAD><PAD><PAD><PAD><PAD><PAD><PAD><PAD><PAD><PAD><PAD><PAD><PAD><PAD><PAD><PAD><PAD><PAD><PAD><PAD><PAD><PAD><PAD><PAD><PAD><PAD><PAD><PAD><PAD><PAD><PAD><PAD><PAD><PAD><PAD><PAD><PAD><PAD><PAD><PAD><PAD><PAD><PAD><PAD>
<CLS>CC(C(=O)NC1=CC(=CC=C1)OC)OC(=O)C2=CC=C(O2)[N+](=O)[O-]<SEP>CCCCCCCCCCCCCCCCCCCCCCCCCCCCCCCCCCCCCCCCCCCC	<CLS>CC(C(=O)NC1=CC(=CC=C1)OC)OC(=O)C2=CC=C(O2)[N+](=O)[O-]<SEP><PAD><PAD><PAD><PAD><PAD><PAD><PAD><PAD><PAD><PAD><PAD><PAD><PAD><PAD><PAD><PAD><PAD><PAD><PAD><PAD><PAD><PAD><PAD><PAD><PAD><PAD><PAD><PAD><PAD><PAD><PAD><PAD><PAD><PAD><PAD><PAD><PAD><PAD><PAD><PAD><PAD><PAD><PAD><PAD>
<CLS>COC1=CC=C(C=C1)CC(=O)NN=CC2=CC3=C(C=C2)O)OCO3<SEP>CCCCCCCCCCCCCCCCCCCCCCCCCCCCCCCCCCCCCCCCCCCCCCCCCCCCC	<CLS>COC1=CC=C(C=C1)CC(=O)NN=CC2=CC3=C(C=C2Br)OCO3<SEP><PAD><PAD><PAD><PAD><PAD><PAD><PAD><PAD><PAD><PAD><PAD><PAD><PAD><PAD><PAD><PAD><PAD><PAD><PAD><PAD><PAD><PAD><PAD><PAD><PAD><PAD><PAD><PAD><PAD><PAD><PAD><PAD><PAD><PAD><PAD><PAD><PAD><PAD><PAD><PAD><PAD><PAD><PAD><PAD><PAD><PAD><PAD><PAD><PAD><PAD><PAD><PAD><PAD>
<CLS>C1OC2=C(O1)C=C(C=C2)CCC(=O)NNC(=O)C3=CC=C(C=C3)CSC4=NC5=CC=CC=C5S4<SEP>CCCCCCCCCCCCCCCCCCCCCCCCCCCCCCCC	<CLS>C1OC2=C(O1)C=C(C=C2)CCC(=O)NNC(=O)C3=CC=C(C=C3)CSC4=NC5=CC=CC=C5S4<SEP><PAD><PAD><PAD><PAD><PAD><PAD><PAD><PAD><PAD><PAD><PAD><PAD><PAD><PAD><PAD><PAD><PAD><PAD><PAD><PAD><PAD><PAD><PAD><PAD><PAD><PAD><PAD><PAD><PAD><PAD><PAD><PAD>
<CLS>CCC1=C2C(=CC=C1)C(=CN2)C(=O)C(C3=CC=CC=C3)SC4=NN=C(S4)NC<SEP>CCCCCCCCCCCCCCCCCCCCCCCCCCCCCCCCCCCCCCCCCC	<CLS>CCC1=C2C(=CC=C1)C(=CN2)C(=O)C(C3=CC=CC=C3)SC4=NN=C(S4)NC<SEP><PAD><PAD><PAD><PAD><PAD><PAD><PAD><PAD><PAD><PAD><PAD><PAD><PAD><PAD><PAD><PAD><PAD><PAD><PAD><PAD><PAD><PAD><PAD><PAD><PAD><PAD><PAD><PAD><PAD><PAD><PAD><PAD><PAD><PAD><PAD><PAD><PAD><PAD><PAD><PAD><PAD><PAD>
<CLS>C=CCNC(=S)N1CCC2CCC3=CC=CC=C3C2(C1)C4=CC=CC=C4Cl<SEP>CCCCCCCCCCCCCCCCCCCCCCCCCCCCCCCCCCCCCCCCCCCCCCCCCC	<CLS>C=CCNC(=S)N1C(C2CCC3=CC=CC=C3C2=N1)C4=CC=CC=C4Cl<SEP><PAD><PAD><PAD><PAD><PAD><PAD><PAD><PAD><PAD><PAD><PAD><PAD><PAD><PAD><PAD><PAD><PAD><PAD><PAD><PAD><PAD><PAD><PAD><PAD><PAD><PAD><PAD><PAD><PAD><PAD><PAD><PAD><PAD><PAD><PAD><PAD><PAD><PAD><PAD><PAD><PAD><PAD><PAD><PAD><PAD><PAD><PAD><PAD><PAD><PAD>
<CLS>COC1=C(C=C(C=C1Cl)Cl)C(=O)NC2=CC=CC(=C2)C3=NC4=C(O3)C=CC(=C4)Cl<SEP>CCCCCCCCCCCCCCCCCCCCCCCCCCCCCCCCCCC	<CLS>COC1=C(C=C(C=C1Cl)Cl)C(=O)NC2=CC=CC(=C2)C3=NC4=C(O3)C=CC(=C4)Cl<SEP><PAD><PAD><PAD><PAD><PAD><PAD><PAD><PAD><PAD><PAD><PAD><PAD><PAD><PAD><PAD><PAD><PAD><PAD><PAD><PAD><PAD><PAD><PAD><PAD><PAD><PAD><PAD><PAD><PAD><PAD><PAD><PAD><PAD><PAD><PAD>
<CLS>CC(C)CN(CC1=NC2=C(N1CCCCC3)N=CC=C2)C(=O)C4=CC=C(S4)SC<SEP>CCCCCCCCCCCCCCCCCCCCCCCCCCCCCCCCCCCCCCCCCCCCC	<CLS>CC(C)CN(CC1=NC2=C(N1CC3CC3)N=CC=C2)C(=O)C4=CC=C(S4)SC<SEP><PAD><PAD><PAD><PAD><PAD><PAD><PAD><PAD><PAD><PAD><PAD><PAD><PAD><PAD><PAD><PAD><PAD><PAD><PAD><PAD><PAD><PAD><PAD><PAD><PAD><PAD><PAD><PAD><PAD><PAD><PAD><PAD><PAD><PAD><PAD><PAD><PAD><PAD><PAD><PAD><PAD><PAD><PAD><PAD><PAD>
<CLS>CCC1C2=C(CC(CC2=O)(C(C)NC3=CC=CC=C3N1CC(=O)N4CCN(CC4)C5=CC=C(C=C5)F<SEP>CCCCCCCCCCCCCCCCCCCCCCCCCCCCCCC	<CLS>CCC1C2=C(CC(CC2=O)(C)C)NC3=CC=CC=C3N1CC(=O)N4CCN(CC4)C5=CC=C(C=C5)F<SEP><PAD><PAD><PAD><PAD><PAD><PAD><PAD><PAD><PAD><PAD><PAD><PAD><PAD><PAD><PAD><PAD><PAD><PAD><PAD><PAD><PAD><PAD><PAD><PAD><PAD><PAD><PAD><PAD><PAD><PAD><PAD>
<CLS>CC(C)(C)C(=O)N(CC1=CC=C(C=C1)F)CC(=O)NC2=C(C3=C(S2)CCCC3)C(=O)N<SEP>CCCCCCCCCCCCCCCCCCCCCCCCCCCCCCCCCCC	<CLS>CC(C)(C)C(=O)N(CC1=CC=C(C=C1)F)CC(=O)NC2=C(C3=C(S2)CCCC3)C(=O)N<SEP><PAD><PAD><PAD><PAD><PAD><PAD><PAD><PAD><PAD><PAD><PAD><PAD><PAD><PAD><PAD><PAD><PAD><PAD><PAD><PAD><PAD><PAD><PAD><PAD><PAD><PAD><PAD><PAD><PAD><PAD><PAD><PAD><PAD><PAD><PAD>
<CLS>COC1=CC(=CC(=C1OC)OC)C2=NN=C(S2)SCC(=O)NC3=NC(=CS3)C4=CC=CC=C4<SEP>CCCCCCCCCCCCCCCCCCCCCCCCCCCCCCCCCCCC	<CLS>COC1=CC(=CC(=C1OC)OC)C2=NN=C(O2)SCC(=O)NC3=NC(=CS3)C4=CC=CC=C4<SEP><PAD><PAD><PAD><PAD><PAD><PAD><PAD><PAD><PAD><PAD><PAD><PAD><PAD><PAD><PAD><PAD><PAD><PAD><PAD><PAD><PAD><PAD><PAD><PAD><PAD><PAD><PAD><PAD><PAD><PAD><PAD><PAD><PAD><PAD><PAD><PAD>
<CLS>CCOC1=C(C=CC(=C1)C=C2C(=N)N3C(=NC2=O)SC(=N3)C4CCN(C44)CC5=CC=CC=C5C#N<SEP>CCCCCCCCCCCCCCCCCCCCCCCCCCCCC	<CLS>CCOC1=C(C=CC(=C1)C=C2C(=N)N3C(=NC2=O)SC(=N3)C4CCCCC4)OCC5=CC=CC=C5C#N<SEP><PAD><PAD><PAD><PAD><PAD><PAD><PAD><PAD><PAD><PAD><PAD><PAD><PAD><PAD><PAD><PAD><PAD><PAD><PAD><PAD><PAD><PAD><PAD><PAD><PAD><PAD><PAD><PAD><PAD>
<CLS>CC(=O)NCCC==NC2=CC=CC=C2N1CCCCOC3=CC=C(C=C3)Cl<SEP>CCCCCCCCCCCCCCCCCCCCCCCCCCCCCCCCCCCCCCCCCCCCCCCCCCCC	<CLS>CC(=O)NCCC1=NC2=CC=CC=C2N1CCCCOC3=CC=C(C=C3)Cl<SEP><PAD><PAD><PAD><PAD><PAD><PAD><PAD><PAD><PAD><PAD><PAD><PAD><PAD><PAD><PAD><PAD><PAD><PAD><PAD><PAD><PAD><PAD><PAD><PAD><PAD><PAD><PAD><PAD><PAD><PAD><PAD><PAD><PAD><PAD><PAD><PAD><PAD><PAD><PAD><PAD><PAD><PAD><PAD><PAD><PAD><PAD><PAD><PAD><PAD><PAD><PAD><PAD>
<CLS>CC1=CC=C(C=C1)COC2=C(C=C(C=C2)C=NNC(=O)CNC(=O)C3=CC(=C(C=C3)OC)OC)OC<SEP>CCCCCCCCCCCCCCCCCCCCCCCCCCCCCC	<CLS>CC1=CC=C(C=C1)COC2=C(C=C(C=C2)C=NNC(=O)CNC(=O)C3=CC(=C(C=C3)OC)OC)OC<SEP><PAD><PAD><PAD><PAD><PAD><PAD><PAD><PAD><PAD><PAD><PAD><PAD><PAD><PAD><PAD><PAD><PAD><PAD><PAD><PAD><PAD><PAD><PAD><PAD><PAD><PAD><PAD><PAD><PAD><PAD>
<CLS>C1CCC(C1)OC2=CC=CC(=C2)NC3=NN4C(=NN=N4)C=C3<SEP>CCCCCCCCCCCCCCCCCCCCCCCCCCCCCCCCCCCCCCCCCCCCCCCCCCCCCCC	<CLS>C1CCC(C1)OC2=CC=CC(=C2)NC3=NN4C(=NN=N4)C=C3<SEP><PAD><PAD><PAD><PAD><PAD><PAD><PAD><PAD><PAD><PAD><PAD><PAD><PAD><PAD><PAD><PAD><PAD><PAD><PAD><PAD><PAD><PAD><PAD><PAD><PAD><PAD><PAD><PAD><PAD><PAD><PAD><PAD><PAD><PAD><PAD><PAD><PAD><PAD><PAD><PAD><PAD><PAD><PAD><PAD><PAD><PAD><PAD><PAD><PAD><PAD><PAD><PAD><PAD><PAD><PAD>
<CLS>CCCCCCCCCCCCCCCC(=O)NN=CC1=CC=C(C=C1)OC(=O)C2=CC=C(C=C2)OCC<SEP>CCCCCCCCCCCCCCCCCCCCCCCCCCCCCCCCCCCCCCC	<CLS>CCCCCCCCCCCCCCCC(=O)NN=CC1=CC=C(C=C1)OC(=O)C2=CC=C(C=C2)OCC<SEP><PAD><PAD><PAD><PAD><PAD><PAD><PAD><PAD><PAD><PAD><PAD><PAD><PAD><PAD><PAD><PAD><PAD><PAD><PAD><PAD><PAD><PAD><PAD><PAD><PAD><PAD><PAD><PAD><PAD><PAD><PAD><PAD><PAD><PAD><PAD><PAD><PAD><PAD><PAD>
<CLS>CCN(CC)CC(=O)N1C2=CC=CC=C2C=CC3=CC=CC=C31<SEP>CCCCCCCCCCCCCCCCCCCCCCCCCCCCCCCCCCCCCCCCCCCCCCCCCCCCCCCCC	<CLS>CCN(CC)CC(=O)N1C2=CC=CC=C2C=CC3=CC=CC=C31<SEP><PAD><PAD><PAD><PAD><PAD><PAD><PAD><PAD><PAD><PAD><PAD><PAD><PAD><PAD><PAD><PAD><PAD><PAD><PAD><PAD><PAD><PAD><PAD><PAD><PAD><PAD><PAD><PAD><PAD><PAD><PAD><PAD><PAD><PAD><PAD><PAD><PAD><PAD><PAD><PAD><PAD><PAD><PAD><PAD><PAD><PAD><PAD><PAD><PAD><PAD><PAD><PAD><PAD><PAD><PAD><PAD><PAD>
<CLS>CCCCCCOC1=CC=C(C=C1)C(=O)OC2=C(C=C(C=C2)Br)C(C)(C)C<SEP>CCCCCCCCCCCCCCCCCCCCCCCCCCCCCCCCCCCCCCCCCCCCCCC	<CLS>CCCCCCOC1=CC=C(C=C1)C(=O)OC2=C(C=C(C=C2)Br)C(C)(C)C<SEP><PAD><PAD><PAD><PAD><PAD><PAD><PAD><PAD><PAD><PAD><PAD><PAD><PAD><PAD><PAD><PAD><PAD><PAD><PAD><PAD><PAD><PAD><PAD><PAD><PAD><PAD><PAD><PAD><PAD><PAD><PAD><PAD><PAD><PAD><PAD><PAD><PAD><PAD><PAD><PAD><PAD><PAD><PAD><PAD><PAD><PAD><PAD>
<CLS>CC1=C(C=C(C=C1)N2C(=NN=N2)SCC(=O)C3=C(N(C(=C3)C)C4=NC=CS4)C)C<SEP>CCCCCCCCCCCCCCCCCCCCCCCCCCCCCCCCCCCCC	<CLS>CC1=C(C=C(C=C1)N2C(=NN=N2)SCC(=O)C3=C(N(C(=C3)C)C4=NC=CS4)C)C<SEP><PAD><PAD><PAD><PAD><PAD><PAD><PAD><PAD><PAD><PAD><PAD><PAD><PAD><PAD><PAD><PAD><PAD><PAD><PAD><PAD><PAD><PAD><PAD><PAD><PAD><PAD><PAD><PAD><PAD><PAD><PAD><PAD><PAD><PAD><PAD><PAD><PAD>
<CLS>CC1=CC(=CC=C1)OC2=C(C=C(C=C2)C)C<SEP>CCCCCCCCCCCCCCCCCCCCCCCCCCCCCCCCCCCCCCCCCCCCCCCCCCCCCCCCCCCCCCCCCC	<CLS>CC1=CC(=CC=C1)OC2=C(C=C(C=C2)C)C<SEP><PAD><PAD><PAD><PAD><PAD><PAD><PAD><PAD><PAD><PAD><PAD><PAD><PAD><PAD><PAD><PAD><PAD><PAD><PAD><PAD><PAD><PAD><PAD><PAD><PAD><PAD><PAD><PAD><PAD><PAD><PAD><PAD><PAD><PAD><PAD><PAD><PAD><PAD><PAD><PAD><PAD><PAD><PAD><PAD><PAD><PAD><PAD><PAD><PAD><PAD><PAD><PAD><PAD><PAD><PAD><PAD><PAD><PAD><PAD><PAD><PAD><PAD><PAD><PAD><PAD><PAD>
<CLS>C1CC(OC1)CN2C(=NN=C2SCN3C(=O)C4=CC=CC=C4N=N3)C5=CC=CS5<SEP>CCCCCCCCCCCCCCCCCCCCCCCCCCCCCCCCCCCCCCCCCCCC	<CLS>C1CC(OC1)CN2C(=NN=C2SCN3C(=O)C4=CC=CC=C4N=N3)C5=CC=CS5<SEP><PAD><PAD><PAD><PAD><PAD><PAD><PAD><PAD><PAD><PAD><PAD><PAD><PAD><PAD><PAD><PAD><PAD><PAD><PAD><PAD><PAD><PAD><PAD><PAD><PAD><PAD><PAD><PAD><PAD><PAD><PAD><PAD><PAD><PAD><PAD><PAD><PAD><PAD><PAD><PAD><PAD><PAD><PAD><PAD>
<CLS>COC1=C(C=C(C=C1)NC(=S)NC2CCCCC2)CC<SEP>CCCCCCCCCCCCCCCCCCCCCCCCCCCCCCCCCCCCCCCCCCCCCCCCCCCCCCCCCCCCCCCC	<CLS>COC1=C(C=C(C=C1)NC(=S)NC2CCCCC2)Cl<SEP><PAD><PAD><PAD><PAD><PAD><PAD><PAD><PAD><PAD><PAD><PAD><PAD><PAD><PAD><PAD><PAD><PAD><PAD><PAD><PAD><PAD><PAD><PAD><PAD><PAD><PAD><PAD><PAD><PAD><PAD><PAD><PAD><PAD><PAD><PAD><PAD><PAD><PAD><PAD><PAD><PAD><PAD><PAD><PAD><PAD><PAD><PAD><PAD><PAD><PAD><PAD><PAD><PAD><PAD><PAD><PAD><PAD><PAD><PAD><PAD><PAD><PAD><PAD><PAD>
<CLS>CC(C1=CC=C(C=C1)Cl)NC(=O)COC(=O)C2=CC=CC=[N+]2[O-]<SEP>CCCCCCCCCCCCCCCCCCCCCCCCCCCCCCCCCCCCCCCCCCCCCCCC	<CLS>CC(C1=CC=C(C=C1)Cl)NC(=O)COC(=O)C2=CC=CC=[N+]2[O-]<SEP><PAD><PAD><PAD><PAD><PAD><PAD><PAD><PAD><PAD><PAD><PAD><PAD><PAD><PAD><PAD><PAD><PAD><PAD><PAD><PAD><PAD><PAD><PAD><PAD><PAD><PAD><PAD><PAD><PAD><PAD><PAD><PAD><PAD><PAD><PAD><PAD><PAD><PAD><PAD><PAD><PAD><PAD><PAD><PAD><PAD><PAD><PAD><PAD>
<CLS>CCC1=CC(=C(C=C1)C)N<SEP>CCCCCCCCCCCCCCCCCCCCCCCCCCCCCCCCCCCCCCCCCCCCCCCCCCCCCCCCCCCCCCCCCCCCCCCCCCCCCCC	<CLS>CCC1=CC(=C(C=C1)O)N<SEP><PAD><PAD><PAD><PAD><PAD><PAD><PAD><PAD><PAD><PAD><PAD><PAD><PAD><PAD><PAD><PAD><PAD><PAD><PAD><PAD><PAD><PAD><PAD><PAD><PAD><PAD><PAD><PAD><PAD><PAD><PAD><PAD><PAD><PAD><PAD><PAD><PAD><PAD><PAD><PAD><PAD><PAD><PAD><PAD><PAD><PAD><PAD><PAD><PAD><PAD><PAD><PAD><PAD><PAD><PAD><PAD><PAD><PAD><PAD><PAD><PAD><PAD><PAD><PAD><PAD><PAD><PAD><PAD><PAD><PAD><PAD><PAD><PAD><PAD><PAD><PAD><PAD><PAD><PAD>
<CLS>CC1CCC(CC1)CN2CCN(CC2)C(=O)NC3=CC=C(C=C3)Cl<SEP>CCCCCCCCCCCCCCCCCCCCCCCCCCCCCCCCCCCCCCCCCCCCCCCCCCCCCCC	<CLS>CC1CCC(CC1)CC2CCN(CC2)C(=O)NC3=CC=C(C=C3)Cl<SEP><PAD><PAD><PAD><PAD><PAD><PAD><PAD><PAD><PAD><PAD><PAD><PAD><PAD><PAD><PAD><PAD><PAD><PAD><PAD><PAD><PAD><PAD><PAD><PAD><PAD><PAD><PAD><PAD><PAD><PAD><PAD><PAD><PAD><PAD><PAD><PAD><PAD><PAD><PAD><PAD><PAD><PAD><PAD><PAD><PAD><PAD><PAD><PAD><PAD><PAD><PAD><PAD><PAD><PAD><PAD>
<CLS>CC1=CC(=CC(=C1)NC(=O)C=CC2=CC=C(C=C2)C(=O)O))C<SEP>CCCCCCCCCCCCCCCCCCCCCCCCCCCCCCCCCCCCCCCCCCCCCCCCCCCC	<CLS>CC1=CC(=CC(=C1)NC(=O)C=CC2=CC=C(C=C2)C(=O)OC)C<SEP><PAD><PAD><PAD><PAD><PAD><PAD><PAD><PAD><PAD><PAD><PAD><PAD><PAD><PAD><PAD><PAD><PAD><PAD><PAD><PAD><PAD><PAD><PAD><PAD><PAD><PAD><PAD><PAD><PAD><PAD><PAD><PAD><PAD><PAD><PAD><PAD><PAD><PAD><PAD><PAD><PAD><PAD><PAD><PAD><PAD><PAD><PAD><PAD><PAD><PAD><PAD><PAD>
<CLS>C1CCC(C1)NC(=O)C(C2=CC=C(C=C2)N3CCOCC3)N(C4=CC=C(C=C4)F)C(=O)C5=CC=CO5<SEP>CCCCCCCCCCCCCCCCCCCCCCCCCCCC	<CLS>C1CCC(C1)NC(=O)C(C2=CC=C(C=C2)N3CCOCC3)N(C4=CC=C(C=C4)F)C(=O)C5=CC=CO5<SEP><PAD><PAD><PAD><PAD><PAD><PAD><PAD><PAD><PAD><PAD><PAD><PAD><PAD><PAD><PAD><PAD><PAD><PAD><PAD><PAD><PAD><PAD><PAD><PAD><PAD><PAD><PAD><PAD>
<CLS>CCC1=CC2=C(C=C1)OC3=C2C(=O)N(N(C3=O)CCN4CCOCC4)C5=CC=CS5<SEP>CCCCCCCCCCCCCCCCCCCCCCCCCCCCCCCCCCCCCCCCCC	<CLS>CCC1=CC2=C(C=C1)OC3=C(C2=O)C(N(C3=O)CCN4CCOCC4)C5=CC=CS5<SEP><PAD><PAD><PAD><PAD><PAD><PAD><PAD><PAD><PAD><PAD><PAD><PAD><PAD><PAD><PAD><PAD><PAD><PAD><PAD><PAD><PAD><PAD><PAD><PAD><PAD><PAD><PAD><PAD><PAD><PAD><PAD><PAD><PAD><PAD><PAD><PAD><PAD><PAD><PAD><PAD><PAD><PAD>
<CLS>CC1=CC(=NN1C)C(=O)N2CCC3(CC2)CCN(C3)CC4=CC=CC=C4OCC(C)C<SEP>CCCCCCCCCCCCCCCCCCCCCCCCCCCCCCCCCCCCCCCCCCC	<CLS>CC1=CC(=NN1C)C(=O)N2CCC3(CC2)CCN(C3)CC4=CC=CC=C4OCC(C)C<SEP><PAD><PAD><PAD><PAD><PAD><PAD><PAD><PAD><PAD><PAD><PAD><PAD><PAD><PAD><PAD><PAD><PAD><PAD><PAD><PAD><PAD><PAD><PAD><PAD><PAD><PAD><PAD><PAD><PAD><PAD><PAD><PAD><PAD><PAD><PAD><PAD><PAD><PAD><PAD><PAD><PAD><PAD><PAD>
<CLS>CC=CCOC1=CC=CC=C1F<SEP>CCCCCCCCCCCCCCCCCCCCCCCCCCCCCCCCCCCCCCCCCCCCCCCCCCCCCCCCCCCCCCCCCCCCCCCCCCCCCCCC	<CLS>CC=CCCC1=CC=CC=C1C<SEP><PAD><PAD><PAD><PAD><PAD><PAD><PAD><PAD><PAD><PAD><PAD><PAD><PAD><PAD><PAD><PAD><PAD><PAD><PAD><PAD><PAD><PAD><PAD><PAD><PAD><PAD><PAD><PAD><PAD><PAD><PAD><PAD><PAD><PAD><PAD><PAD><PAD><PAD><PAD><PAD><PAD><PAD><PAD><PAD><PAD><PAD><PAD><PAD><PAD><PAD><PAD><PAD><PAD><PAD><PAD><PAD><PAD><PAD><PAD><PAD><PAD><PAD><PAD><PAD><PAD><PAD><PAD><PAD><PAD><PAD><PAD><PAD><PAD><PAD><PAD><PAD><PAD><PAD><PAD><PAD>
<CLS>COC1=C(C=C(C=C1)C2C(SC3=NN=C(N3N2)N4CCOCC4)C(=O)C5=CC=C(C=C5)F)OC<SEP>CCCCCCCCCCCCCCCCCCCCCCCCCCCCCCCCC	<CLS>COC1=C(C=C(C=C1)C2C(SC3=NN=C(N3N2)C4CCCCC4)C(=O)C5=CC=C(C=C5)F)OC<SEP><PAD><PAD><PAD><PAD><PAD><PAD><PAD><PAD><PAD><PAD><PAD><PAD><PAD><PAD><PAD><PAD><PAD><PAD><PAD><PAD><PAD><PAD><PAD><PAD><PAD><PAD><PAD><PAD><PAD><PAD><PAD><PAD><PAD>
<CLS>CCN(CC)C(=O)CN(CCCO)C1=CC=CC=C1<SEP>CCCCCCCCCCCCCCCCCCCCCCCCCCCCCCCCCCCCCCCCCCCCCCCCCCCCCCCCCCCCCCCCCCC	<CLS>CCN(CC)C(=O)CN(CCCN)C1=CC=CC=C1<SEP><PAD><PAD><PAD><PAD><PAD><PAD><PAD><PAD><PAD><PAD><PAD><PAD><PAD><PAD><PAD><PAD><PAD><PAD><PAD><PAD><PAD><PAD><PAD><PAD><PAD><PAD><PAD><PAD><PAD><PAD><PAD><PAD><PAD><PAD><PAD><PAD><PAD><PAD><PAD><PAD><PAD><PAD><PAD><PAD><PAD><PAD><PAD><PAD><PAD><PAD><PAD><PAD><PAD><PAD><PAD><PAD><PAD><PAD><PAD><PAD><PAD><PAD><PAD><PAD><PAD><PAD><PAD>
<CLS>C[N+](C)(CC1=CC=C(C=C1)CC)C2C3=CC=CC=C3C4=CC=CC=C24.[Br-]<SEP>CCCCCCCCCCCCCCCCCCCCCCCCCCCCCCCCCCCCCCCCC	<CLS>C[N+](C)(CC1=CC=C(C=C1)Br)C2C3=CC=CC=C3C4=CC=CC=C24.[Br-]<SEP><PAD><PAD><PAD><PAD><PAD><PAD><PAD><PAD><PAD><PAD><PAD><PAD><PAD><PAD><PAD><PAD><PAD><PAD><PAD><PAD><PAD><PAD><PAD><PAD><PAD><PAD><PAD><PAD><PAD><PAD><PAD><PAD><PAD><PAD><PAD><PAD><PAD><PAD><PAD><PAD><PAD>
<CLS>CC1=C(NC(=C1C(=O)O)C)C(=O)NCC(=O)N2CCN(CC2)S(=O)(=O)C3=CC=C(C=C3)Cl<SEP>CC<SEP>CCCCCCCCCCCCCCCCCCCCCCCCCCCC	<CLS>CC1=C(NC(=C1C(=O)C)C)C(=O)OCC(=O)N2CCN(CC2)S(=O)(=O)C3=CC=C(C=C3)Cl<SEP><PAD><PAD><PAD><PAD><PAD><PAD><PAD><PAD><PAD><PAD><PAD><PAD><PAD><PAD><PAD><PAD><PAD><PAD><PAD><PAD><PAD><PAD><PAD><PAD><PAD><PAD><PAD><PAD><PAD><PAD><PAD>
<CLS>CC1=C((=C(C=C1)C)CCN2CCN(CC2)C)CC3=CC=CC=C3<SEP>CCCCCCCCCCCCCCCCCCCCCCCCCCCCCCCCCCCCCCCCCCCCCCCCCCCCCCC	<CLS>CC1=CC(=C(C=C1)OCCCN2CCN(CC2)C)CC3=CC=CC=C3<SEP><PAD><PAD><PAD><PAD><PAD><PAD><PAD><PAD><PAD><PAD><PAD><PAD><PAD><PAD><PAD><PAD><PAD><PAD><PAD><PAD><PAD><PAD><PAD><PAD><PAD><PAD><PAD><PAD><PAD><PAD><PAD><PAD><PAD><PAD><PAD><PAD><PAD><PAD><PAD><PAD><PAD><PAD><PAD><PAD><PAD><PAD><PAD><PAD><PAD><PAD><PAD><PAD><PAD><PAD><PAD>
<CLS>CC1=C2C(=NC(=N1)N3CCN(CC3)C4=CC=CC(=C4)C(F)(F)F)C(=C)(=O)CC=CC=CS5<SEP>CCCCCCCCCCCCCCCCCCCCCCCCCCCCCCCC	<CLS>CC1=C2C(=NC(=N1)N3CCN(CC3)C4=CC=CC(=C4)C(F)(F)F)CC(CC2=O)C5=CC=CS5<SEP><PAD><PAD><PAD><PAD><PAD><PAD><PAD><PAD><PAD><PAD><PAD><PAD><PAD><PAD><PAD><PAD><PAD><PAD><PAD><PAD><PAD><PAD><PAD><PAD><PAD><PAD><PAD><PAD><PAD><PAD><PAD><PAD>
<CLS>CC(C)C1=C(C(=CC=C1)C(C)C)NC(=O)CSC2=NN=C(N2C4=CC=CC=C4C(=O)N3CCCC<SEP>CCCCCCCCCCCCCCCCCCCCCCCCCCCCCCCCC	<CLS>CC(C)C1=C(C(=CC=C1)C(C)C)NC(=O)CSC2=NN=C3N2C4=CC=CC=C4C(=O)N3CC=C<SEP><PAD><PAD><PAD><PAD><PAD><PAD><PAD><PAD><PAD><PAD><PAD><PAD><PAD><PAD><PAD><PAD><PAD><PAD><PAD><PAD><PAD><PAD><PAD><PAD><PAD><PAD><PAD><PAD><PAD><PAD><PAD><PAD><PAD>
<CLS>C[NH+](CC1=C(C=C(C=C1)OC)OC)CC(=O)NC2=CC=CC=C2[N+](=O)[O-]<SEP>CCCCCCCCCCCCCCCCCCCCCCCCCCCCCCCCCCCCCCCC	<CLS>C[NH+](CC1=C(C=C(C=C1)OC)OC)CC(=O)NC2=CC=CC=C2[N+](=O)[O-]<SEP><PAD><PAD><PAD><PAD><PAD><PAD><PAD><PAD><PAD><PAD><PAD><PAD><PAD><PAD><PAD><PAD><PAD><PAD><PAD><PAD><PAD><PAD><PAD><PAD><PAD><PAD><PAD><PAD><PAD><PAD><PAD><PAD><PAD><PAD><PAD><PAD><PAD><PAD><PAD><PAD>
<CLS>C1C2=C(C(=CC(=C2)Cl)COC(=O)C3=CC4=C(C=C3)C(=O)N(C4=O)C5=CC=CC=C5Cl)OCO1<SEP>CCCCCCCCCCCCCCCCCCCCCCCCCCC	<CLS>C1C2=C(C(=CC(=C2)Cl)COC(=O)C3=CC4=C(C=C3)C(=O)N(C4=O)C5=CC=CC=C5Cl)OCO1<SEP><PAD><PAD><PAD><PAD><PAD><PAD><PAD><PAD><PAD><PAD><PAD><PAD><PAD><PAD><PAD><PAD><PAD><PAD><PAD><PAD><PAD><PAD><PAD><PAD><PAD><PAD><PAD>
<CLS>CC(C)(C=CC(=O)NC1=CC=CC=C1F)C(C2=C(C=C(C=C2)I)I)NC(=O)NC3=CC4CC(C=CC)OCC4<SEP>CCCCCCCCCCCCCCCCCCCCCCCCC	<CLS>CC(C)(C=CC(=O)NC1=CC=CC=C1N)C(C2=C(C=CC(=C2)I)O)OC(=O)NC3=CC4=C(C=C3)OCO4<SEP><PAD><PAD><PAD><PAD><PAD><PAD><PAD><PAD><PAD><PAD><PAD><PAD><PAD><PAD><PAD><PAD><PAD><PAD><PAD><PAD><PAD><PAD><PAD><PAD><PAD>
<CLS>CC1=C(C(CCC=CCCCCC3=CCC44(C3CC5C2(C(=O)N(C5=O)C6=CC=CC=C6)C)C(=O)NCC4=C)CC7=CC=CS7)C<SEP>CCCCCCCCCCCCCC	<CLS>CC1=C(C(=CC=C1)C2C3=CCC4C(C3CC5C2(C(=O)N(C5=O)C6=CC=CC=C6)C)C(=O)N(C4=O)CC7=CC=CS7)O<SEP><PAD><PAD><PAD><PAD><PAD><PAD><PAD><PAD><PAD><PAD><PAD><PAD><PAD><PAD>
<CLS>COC1=C(C=C2C(=C1)CN(C2=O)CC3CCCN(C3)CCC4=CC=C(C=C4)NS(=O)(=O)C)OC<SEP>CCCCCCCCCCCCCCCCCCCCCCCCCCCCCCCCC	<CLS>COC1=C(C=C2C(=C1)CN(C2=O)CC3CCCN(C3)CCC4=CC=C(C=C4)NS(=O)(=O)C)OC<SEP><PAD><PAD><PAD><PAD><PAD><PAD><PAD><PAD><PAD><PAD><PAD><PAD><PAD><PAD><PAD><PAD><PAD><PAD><PAD><PAD><PAD><PAD><PAD><PAD><PAD><PAD><PAD><PAD><PAD><PAD><PAD><PAD><PAD>
<CLS>CCOC1=C(C(=C(N=C2N1CC(=O)N2)CC3=CC=C(C=C3)C4=CC=CC=C4C(=O)OC<SEP>CCCCCCCCCCCCCCCCCCCCCCCCCCCCCCCCCCCCCC	<CLS>CCCC1=C(C(=O)N=C2N1CC(=O)N2)CC3=CC=C(C=C3)C4=CC=CC=C4C(=O)OC<SEP><PAD><PAD><PAD><PAD><PAD><PAD><PAD><PAD><PAD><PAD><PAD><PAD><PAD><PAD><PAD><PAD><PAD><PAD><PAD><PAD><PAD><PAD><PAD><PAD><PAD><PAD><PAD><PAD><PAD><PAD><PAD><PAD><PAD><PAD><PAD><PAD><PAD><PAD>
<CLS>CC(=O)C1=CC(=C(C=C1)N2CCN(CC2)C(=O)C3=CC(=C(C=C3Br)F)F)F<SEP>CCCCCCCCCCCCCCCCCCCCCCCCCCCCCCCCCCCCCCCCCC	<CLS>CC(=O)C1=CC(=C(C=C1)N2CCN(CC2)C(=O)C3=CC(=C(C=C3Br)F)F)F<SEP><PAD><PAD><PAD><PAD><PAD><PAD><PAD><PAD><PAD><PAD><PAD><PAD><PAD><PAD><PAD><PAD><PAD><PAD><PAD><PAD><PAD><PAD><PAD><PAD><PAD><PAD><PAD><PAD><PAD><PAD><PAD><PAD><PAD><PAD><PAD><PAD><PAD><PAD><PAD><PAD><PAD><PAD>
<CLS>CC1=CC=C(C=C1)S(=O)(=O)N(CC(=O)NCC2=CC=C(C=C2)OCC3=CC=CC=C3Cl<SEP>CCCCCCCCCCCCCCCCCCCCCCCCCCCCCCCCCCCCC	<CLS>CC1=CC=C(C=C1)S(=O)(=O)N(CC(=O)NCC2=CC=CC(=C2)C)C3=CC=CC=C3Cl<SEP><PAD><PAD><PAD><PAD><PAD><PAD><PAD><PAD><PAD><PAD><PAD><PAD><PAD><PAD><PAD><PAD><PAD><PAD><PAD><PAD><PAD><PAD><PAD><PAD><PAD><PAD><PAD><PAD><PAD><PAD><PAD><PAD><PAD><PAD><PAD><PAD><PAD>
<CLS>CN1C2=CC=CC=C2N=C1CCN3C(CCC3=O)CCNCC4=CC(=CC=C4)C(F)(F)F<SEP>CCCCCCCCCCCCCCCCCCCCCCCCCCCCCCCCCCCCCCCCCC	<CLS>CN1C2=CC=CC=C2N=C1CCN3C(CCC3=O)CCNCC4=CC(=CC=C4)C(F)(F)F<SEP><PAD><PAD><PAD><PAD><PAD><PAD><PAD><PAD><PAD><PAD><PAD><PAD><PAD><PAD><PAD><PAD><PAD><PAD><PAD><PAD><PAD><PAD><PAD><PAD><PAD><PAD><PAD><PAD><PAD><PAD><PAD><PAD><PAD><PAD><PAD><PAD><PAD><PAD><PAD><PAD><PAD><PAD>
<CLS>CC(=[N+]1CCC(C1)OC2=CC=C(C=C2)C(C(=O)O)OC3=CC4=C(CC[N+](=)(C)N=C4)C)C3=N<SEP>CCCCCCCCCCCCCCCCCCCCCCCCCC	<CLS>CC(=[N+]1CCC(C1)OC2=CC=C(C=C2)C(C(=O)O)OC3=CC4=C(CC[N+](=C(N)N)C4)C=C3)N<SEP><PAD><PAD><PAD><PAD><PAD><PAD><PAD><PAD><PAD><PAD><PAD><PAD><PAD><PAD><PAD><PAD><PAD><PAD><PAD><PAD><PAD><PAD><PAD><PAD><PAD><PAD>
<CLS>CC(=NOCC1=CC=C(C=C1)C#N)C2=CC=C(C=C2)NC3=NC=NC4=CC=CC=C43<SEP>CCCCCCCCCCCCCCCCCCCCCCCCCCCCCCCCCCCCCCCCC	<CLS>CC(=NOCC1=CC=C(C=C1)C#N)C2=CC=C(C=C2)NC3=NC=NC4=CC=CC=C43<SEP><PAD><PAD><PAD><PAD><PAD><PAD><PAD><PAD><PAD><PAD><PAD><PAD><PAD><PAD><PAD><PAD><PAD><PAD><PAD><PAD><PAD><PAD><PAD><PAD><PAD><PAD><PAD><PAD><PAD><PAD><PAD><PAD><PAD><PAD><PAD><PAD><PAD><PAD><PAD><PAD><PAD>
<CLS>CC(C)C1=C2C(=CC=C1)S(=O)(=O)N(C2=O)CN3C(=CC=C3)S(=O)(=O)C4=CC=CC==4<SEP>CCCCCCCCCCCCCCCCCCCCCCCCCCCCCCC	<CLS>CC(C)C1=C2C(=CC=C1)S(=O)(=O)N(C2=O)CN3C(=CN=N3)S(=O)(=O)C4=CC=CC=C4<SEP><PAD><PAD><PAD><PAD><PAD><PAD><PAD><PAD><PAD><PAD><PAD><PAD><PAD><PAD><PAD><PAD><PAD><PAD><PAD><PAD><PAD><PAD><PAD><PAD><PAD><PAD><PAD><PAD><PAD><PAD><PAD>
<CLS>COC1=CC=C(C=C1)C2=CCN3C2=NC=C3<SEP>CCCCCCCCCCCCCCCCCCCCCCCCCCCCCCCCCCCCCCCCCCCCCCCCCCCCCCCCCCCCCCCCCCCC	<CLS>COC1=CC=C(C=C1)C2=CNN3C2=NC=C3<SEP><PAD><PAD><PAD><PAD><PAD><PAD><PAD><PAD><PAD><PAD><PAD><PAD><PAD><PAD><PAD><PAD><PAD><PAD><PAD><PAD><PAD><PAD><PAD><PAD><PAD><PAD><PAD><PAD><PAD><PAD><PAD><PAD><PAD><PAD><PAD><PAD><PAD><PAD><PAD><PAD><PAD><PAD><PAD><PAD><PAD><PAD><PAD><PAD><PAD><PAD><PAD><PAD><PAD><PAD><PAD><PAD><PAD><PAD><PAD><PAD><PAD><PAD><PAD><PAD><PAD><PAD><PAD><PAD>
<CLS>CCCCCCCCOC1=CC=C(C=C1)C2=C(C(=C(C=C2)C(=O)O)C3=CC=C(C=C3)C(=O)C(C)(CCCCCCF<SEP>CCCCCCCCCCCCCCCCCCCCCCCC	<CLS>CCCCCCCCOC1=CC=C(C=C1)C2=C(C(=C(C=C2)C(=O)O)C3=CC=C(C=C3)C(=O)C(C)CCCCCC)F<SEP><PAD><PAD><PAD><PAD><PAD><PAD><PAD><PAD><PAD><PAD><PAD><PAD><PAD><PAD><PAD><PAD><PAD><PAD><PAD><PAD><PAD><PAD><PAD><PAD>
<CLS>CC1=CC=C(C=C1)C2=CN=C(O2)C3=CC=CC=C3C(=O)N4CCN(CC4)C5=CC=CC(=C5)C<SEP>CCCCCCCCCCCCCCCCCCCCCCCCCCCCCCCCC	<CLS>CC1=CC=C(C=C1)C2=CN=C(O2)C3=CC=CC=C3C(=O)N4CCN(CC4)C5=CC=CC(=C5)C<SEP><PAD><PAD><PAD><PAD><PAD><PAD><PAD><PAD><PAD><PAD><PAD><PAD><PAD><PAD><PAD><PAD><PAD><PAD><PAD><PAD><PAD><PAD><PAD><PAD><PAD><PAD><PAD><PAD><PAD><PAD><PAD><PAD><PAD>
<CLS>C1COC2=C(O1)C=CC(=C2)S(=O)(=O)NC3=CC=C(C=C3)NS(=O)(=O)N<SEP>CCCCCCCCCCCCCCCCCCCCCCCCCCCCCCCCCCCCCCCCCCC	<CLS>C1COC2=C(O1)C=CC(=C2)S(=O)(=O)NC3=CC=C(C=C3)CS(=O)(=O)N<SEP><PAD><PAD><PAD><PAD><PAD><PAD><PAD><PAD><PAD><PAD><PAD><PAD><PAD><PAD><PAD><PAD><PAD><PAD><PAD><PAD><PAD><PAD><PAD><PAD><PAD><PAD><PAD><PAD><PAD><PAD><PAD><PAD><PAD><PAD><PAD><PAD><PAD><PAD><PAD><PAD><PAD><PAD><PAD>
<CLS>C1=CC=C(C(=C1)COC2=CC=CC(=C2)C=C3C(=O)OC(=N3)C4=CC=CC=C4Br)I<SEP>CCCCCCCCCCCCCCCCCCCCCCCCCCCCCCCCCCCCCC	<CLS>C1=CC=C(C(=C1)COC2=CC=CC(=C2)C=C3C(=O)OC(=N3)C4=CC=CC=C4Br)I<SEP><PAD><PAD><PAD><PAD><PAD><PAD><PAD><PAD><PAD><PAD><PAD><PAD><PAD><PAD><PAD><PAD><PAD><PAD><PAD><PAD><PAD><PAD><PAD><PAD><PAD><PAD><PAD><PAD><PAD><PAD><PAD><PAD><PAD><PAD><PAD><PAD><PAD><PAD>
<CLS>C1=CN(N=C1C(F)(F)F)CC2=CSC(=C2)C=O<SEP>CCCCCCCCCCCCCCCCCCCCCCCCCCCCCCCCCCCCCCCCCCCCCCCCCCCCCCCCCCCCCCCC	<CLS>C1=CN(N=C1C(F)(F)F)CC2=CSC(=C2)C=O<SEP><PAD><PAD><PAD><PAD><PAD><PAD><PAD><PAD><PAD><PAD><PAD><PAD><PAD><PAD><PAD><PAD><PAD><PAD><PAD><PAD><PAD><PAD><PAD><PAD><PAD><PAD><PAD><PAD><PAD><PAD><PAD><PAD><PAD><PAD><PAD><PAD><PAD><PAD><PAD><PAD><PAD><PAD><PAD><PAD><PAD><PAD><PAD><PAD><PAD><PAD><PAD><PAD><PAD><PAD><PAD><PAD><PAD><PAD><PAD><PAD><PAD><PAD><PAD><PAD>
<CLS>CC(C)C(C(=O)N)NC(=O)C1CC(CCN1C(=O)C(C)(C)NC(=O)CC2=CC=CS2<SEP>CCCCCCCCCCCCCCCCCCCCCCCCCCCCCCCCCCCCCCCCC	<CLS>CC(C)C(C(=O)N)NC(=O)C1CC(CCN1C(=O)C(C)NC)NC(=O)CC2=CC=CS2<SEP><PAD><PAD><PAD><PAD><PAD><PAD><PAD><PAD><PAD><PAD><PAD><PAD><PAD><PAD><PAD><PAD><PAD><PAD><PAD><PAD><PAD><PAD><PAD><PAD><PAD><PAD><PAD><PAD><PAD><PAD><PAD><PAD><PAD><PAD><PAD><PAD><PAD><PAD><PAD><PAD><PAD>
<CLS>CN1CCN(CC1)C2=CC=C(C=C2)C3=NC4=C(C=CC=C4N3)C(=O)N<SEP>CCCCCCCCCCCCCCCCCCCCCCCCCCCCCCCCCCCCCCCCCCCCCCCCC	<CLS>CN1CCN(CC1)C2=CC=C(C=C2)C3=NC4=C(C=CC=C4N3)C(=O)N<SEP><PAD><PAD><PAD><PAD><PAD><PAD><PAD><PAD><PAD><PAD><PAD><PAD><PAD><PAD><PAD><PAD><PAD><PAD><PAD><PAD><PAD><PAD><PAD><PAD><PAD><PAD><PAD><PAD><PAD><PAD><PAD><PAD><PAD><PAD><PAD><PAD><PAD><PAD><PAD><PAD><PAD><PAD><PAD><PAD><PAD><PAD><PAD><PAD><PAD>
<CLS>CCOC(=O)C1=NN(C2=C1CCN(C2=O)C3=CC=CC=C3)C4=CC(=CC=C4)Cl<SEP>CCCCCCCCCCCCCCCCCCCCCCCCCCCCCCCCCCCCCCCCCCC	<CLS>CCOC(=O)C1=NN(C2=C1CCN(C2=O)C3=CC=CC=C3)C4=CC(=CC=C4)Cl<SEP><PAD><PAD><PAD><PAD><PAD><PAD><PAD><PAD><PAD><PAD><PAD><PAD><PAD><PAD><PAD><PAD><PAD><PAD><PAD><PAD><PAD><PAD><PAD><PAD><PAD><PAD><PAD><PAD><PAD><PAD><PAD><PAD><PAD><PAD><PAD><PAD><PAD><PAD><PAD><PAD><PAD><PAD><PAD>
