output	target
<CLS>CC1=C(C=C(C=C1)OCC(=O)NN=CC2=C(C=CC(=C2)[N+](=O)[O-])O)C<SEP>CCCCCCCCCCCCCCCCCCCCCCCCCCCCCCCCCCCCCCCCCC	<CLS>CC1=C(C=C(C=C1)OCC(=O)NN=CC2=C(C=CC(=C2)[N+](=O)[O-])O)C<SEP><PAD><PAD><PAD><PAD><PAD><PAD><PAD><PAD><PAD><PAD><PAD><PAD><PAD><PAD><PAD><PAD><PAD><PAD><PAD><PAD><PAD><PAD><PAD><PAD><PAD><PAD><PAD><PAD><PAD><PAD><PAD><PAD><PAD><PAD><PAD><PAD><PAD><PAD><PAD><PAD><PAD><PAD>
<CLS>CC(C1=CC=CC=C1OC)C(=O)Cl<SEP>CCCCCCCCCCCCCCCCCCCCCCCCCCCCCCCCCCCCCCCCCCCCCCCCCCCCCCCCCCCCCCCCCCCCCCCCCC	<CLS>CN(C1=CC=CC=C1OC)C(=O)Cl<SEP><PAD><PAD><PAD><PAD><PAD><PAD><PAD><PAD><PAD><PAD><PAD><PAD><PAD><PAD><PAD><PAD><PAD><PAD><PAD><PAD><PAD><PAD><PAD><PAD><PAD><PAD><PAD><PAD><PAD><PAD><PAD><PAD><PAD><PAD><PAD><PAD><PAD><PAD><PAD><PAD><PAD><PAD><PAD><PAD><PAD><PAD><PAD><PAD><PAD><PAD><PAD><PAD><PAD><PAD><PAD><PAD><PAD><PAD><PAD><PAD><PAD><PAD><PAD><PAD><PAD><PAD><PAD><PAD><PAD><PAD><PAD><PAD><PAD><PAD>
<CLS>CCCCCC(C)NC(=O)C1=CN=C(S1)CCC(CNC(C)(C)C)O<SEP>CCCCCCCCCCCCCCCCCCCCCCCCCCCCCCCCCCCCCCCCCCCCCCCCCCCCCCCC	<CLS>CCCCCC(C)NC(=O)C1=CN=C(S1)OCC(CNC(C)(C)C)O<SEP><PAD><PAD><PAD><PAD><PAD><PAD><PAD><PAD><PAD><PAD><PAD><PAD><PAD><PAD><PAD><PAD><PAD><PAD><PAD><PAD><PAD><PAD><PAD><PAD><PAD><PAD><PAD><PAD><PAD><PAD><PAD><PAD><PAD><PAD><PAD><PAD><PAD><PAD><PAD><PAD><PAD><PAD><PAD><PAD><PAD><PAD><PAD><PAD><PAD><PAD><PAD><PAD><PAD><PAD><PAD><PAD>
<CLS>CC1=C(C(=CC=C1)C)NC(=O)C(C2=C(C=CC(=C2)C)C)N(CC#N)C(=O)C(CC3=CC=CC=C3)NC(=O)OC(C)(C)C<SEP>CCCCCCCCCCCCC	<CLS>CC1=C(C(=CC=C1)C)NC(=O)C(C2=CC(=CC(=C2)C)C)N(CC#N)C(=O)C(CC3=CC=CC=C3)NC(=O)OC(C)(C)C<SEP><PAD><PAD><PAD><PAD><PAD><PAD><PAD><PAD><PAD><PAD><PAD><PAD><PAD>
<CLS>C1CC(=CC(=Cl)C1)C=O<SEP>CCCCCCCCCCCCCCCCCCCCCCCCCCCCCCCCCCCCCCCCCCCCCCCCCCCCCCCCCCCCCCCCCCCCCCCCCCCCCCC	<CLS>C1CC(=CC(=CO)C1)C=O<SEP><PAD><PAD><PAD><PAD><PAD><PAD><PAD><PAD><PAD><PAD><PAD><PAD><PAD><PAD><PAD><PAD><PAD><PAD><PAD><PAD><PAD><PAD><PAD><PAD><PAD><PAD><PAD><PAD><PAD><PAD><PAD><PAD><PAD><PAD><PAD><PAD><PAD><PAD><PAD><PAD><PAD><PAD><PAD><PAD><PAD><PAD><PAD><PAD><PAD><PAD><PAD><PAD><PAD><PAD><PAD><PAD><PAD><PAD><PAD><PAD><PAD><PAD><PAD><PAD><PAD><PAD><PAD><PAD><PAD><PAD><PAD><PAD><PAD><PAD><PAD><PAD><PAD><PAD><PAD>
<CLS>CCN1CCN(CC1)C2=C3C=C(C=CC3=NC=C2S(=O)(=O)C4=CC=CC=C4)F<SEP>CCCCCCCCCCCCCCCCCCCCCCCCCCCCCCCCCCCCCCCCCCCC	<CLS>CCN1CCN(CC1)C2=C3C=C(C=CC3=NC=C2S(=O)(=O)C4=CC=CC=C4)F<SEP><PAD><PAD><PAD><PAD><PAD><PAD><PAD><PAD><PAD><PAD><PAD><PAD><PAD><PAD><PAD><PAD><PAD><PAD><PAD><PAD><PAD><PAD><PAD><PAD><PAD><PAD><PAD><PAD><PAD><PAD><PAD><PAD><PAD><PAD><PAD><PAD><PAD><PAD><PAD><PAD><PAD><PAD><PAD><PAD>
<CLS>CCN(CC)C1=CC(=C(C=C1)NC(=O)CC)S(=O)(=O)C2=CC=CC=N2)CCS(=O)(=O)C<SEP>CCCCCCCCCCCCCCCCCCCCCCCCCCCCCCCCCCC	<CLS>CCN(CC)C1=CC(=C(C=C1)NC(=O)OCCS(=O)(=O)C2=CC=CC=N2)CCS(=O)(=O)C<SEP><PAD><PAD><PAD><PAD><PAD><PAD><PAD><PAD><PAD><PAD><PAD><PAD><PAD><PAD><PAD><PAD><PAD><PAD><PAD><PAD><PAD><PAD><PAD><PAD><PAD><PAD><PAD><PAD><PAD><PAD><PAD><PAD><PAD><PAD><PAD>
<CLS>CCOC(=O)C1=NC=NN1CC(CC(C2=C(C(=CC=C2)Cl)Cl)OCC3=CC=CC=C3<SEP>CCCCCCCCCCCCCCCCCCCCCCCCCCCCCCCCCCCCCCCCCC	<CLS>CCOC(=O)C1=NC=NN1CC(CCCC2=C(C(=CC=C2)Cl)Cl)OCC3=CC=CC=C3<SEP><PAD><PAD><PAD><PAD><PAD><PAD><PAD><PAD><PAD><PAD><PAD><PAD><PAD><PAD><PAD><PAD><PAD><PAD><PAD><PAD><PAD><PAD><PAD><PAD><PAD><PAD><PAD><PAD><PAD><PAD><PAD><PAD><PAD><PAD><PAD><PAD><PAD><PAD><PAD><PAD><PAD><PAD>
<CLS>CC1=CC(=CC(=C1NC(=O)C=CC2=CC(=C(C=C2)Cl)[N+](=O)[O-])C)Br<SEP>CCCCCCCCCCCCCCCCCCCCCCCCCCCCCCCCCCCCCCCCC	<CLS>CC1=CC(=CC(=C1NC(=O)C=CC2=CC(=C(C=C2)Cl)[N+](=O)[O-])C)Br<SEP><PAD><PAD><PAD><PAD><PAD><PAD><PAD><PAD><PAD><PAD><PAD><PAD><PAD><PAD><PAD><PAD><PAD><PAD><PAD><PAD><PAD><PAD><PAD><PAD><PAD><PAD><PAD><PAD><PAD><PAD><PAD><PAD><PAD><PAD><PAD><PAD><PAD><PAD><PAD><PAD><PAD>
<CLS>C1=CC=C2C(=C1)C==C(O2)C[N+]3=CC=C(C=C3)C4=CC=C(C=C4)CO)Cl<SEP>CCCCCCCCCCCCCCCCCCCCCCCCCCCCCCCCCCCCCCCCC	<CLS>C1=CC=C2C(=C1)C(=C(S2)C[N+]3=CC=C(C=C3)C4=CC=C(C=C4)CO)Cl<SEP><PAD><PAD><PAD><PAD><PAD><PAD><PAD><PAD><PAD><PAD><PAD><PAD><PAD><PAD><PAD><PAD><PAD><PAD><PAD><PAD><PAD><PAD><PAD><PAD><PAD><PAD><PAD><PAD><PAD><PAD><PAD><PAD><PAD><PAD><PAD><PAD><PAD><PAD><PAD><PAD><PAD>
<CLS>CC1=C(C(N2C(=O)C(=CC3=CC(=C(C=C3)OC)COC4=C(C=C(C=C4)F)F)SC(=N1)C5=CC=C(C=C5)N(C)C)C(=O)OC<SEP>CCCCCCCCC	<CLS>CC1=C(C(N2C(=O)C(=CC3=CC(=C(C=C3)OC)COC4=C(C=C(C=C4)F)F)SC2=N1)C5=CC=C(C=C5)N(C)C)C(=O)OC<SEP><PAD><PAD><PAD><PAD><PAD><PAD><PAD><PAD><PAD>
<CLS>C1CCC(CC1)[Si](Cl)(Cl)Cl<SEP>CCCCCCCCCCCCCCCCCCCCCCCCCCCCCCCCCCCCCCCCCCCCCCCCCCCCCCCCCCCCCCCCCCCCCCCCCC	<CLS>C1CCC(CC1)[Si](Cl)(Cl)Cl<SEP><PAD><PAD><PAD><PAD><PAD><PAD><PAD><PAD><PAD><PAD><PAD><PAD><PAD><PAD><PAD><PAD><PAD><PAD><PAD><PAD><PAD><PAD><PAD><PAD><PAD><PAD><PAD><PAD><PAD><PAD><PAD><PAD><PAD><PAD><PAD><PAD><PAD><PAD><PAD><PAD><PAD><PAD><PAD><PAD><PAD><PAD><PAD><PAD><PAD><PAD><PAD><PAD><PAD><PAD><PAD><PAD><PAD><PAD><PAD><PAD><PAD><PAD><PAD><PAD><PAD><PAD><PAD><PAD><PAD><PAD><PAD><PAD><PAD><PAD>
<CLS>CC(C)(C)C1=CC(=C(C(=C1)NS(=O)(=O)C)OC)NC(=O)NC2=CC=C(C3=CC=CC=C32)C(=O)N4CCOC(C4=CC(=O)NC<SEP>CCCCCCCCC	<CLS>CC(C)(C)C1=CC(=C(C(=C1)NS(=O)(=O)C)OC)NC(=O)NC2=CC=C(C3=CC=CC=C32)C(=O)N4CCOC(C4)CC(=O)OC<SEP><PAD><PAD><PAD><PAD><PAD><PAD><PAD><PAD><PAD>
<CLS>CCCCCCCCCCO)OCC1(C(CCCCC(C(C)C)C(C)C)C(=O)O1)CO<SEP>CCCCCCCCCCCCCCCCCCCCCCCCCCCCCCCCCCCCCCCCCCCCCCCCCCC	<CLS>CCCCCCCC(=O)OCC1(CC(=CCC(C(C)C)C(C)C)C(=O)O1)CO<SEP><PAD><PAD><PAD><PAD><PAD><PAD><PAD><PAD><PAD><PAD><PAD><PAD><PAD><PAD><PAD><PAD><PAD><PAD><PAD><PAD><PAD><PAD><PAD><PAD><PAD><PAD><PAD><PAD><PAD><PAD><PAD><PAD><PAD><PAD><PAD><PAD><PAD><PAD><PAD><PAD><PAD><PAD><PAD><PAD><PAD><PAD><PAD><PAD><PAD><PAD><PAD>
<CLS>C1OC2=C(O1)C=C(C=C2)C=N)C3=CC=C(C=C3)[N+](=O)[O-]<SEP>CCCCCCCCCCCCCCCCCCCCCCCCCCCCCCCCCCCCCCCCCCCCCCCCC	<CLS>C1OC2=C(O1)C=C(C=C2)C=NNC3=CC=C(C=C3)[N+](=O)[O-]<SEP><PAD><PAD><PAD><PAD><PAD><PAD><PAD><PAD><PAD><PAD><PAD><PAD><PAD><PAD><PAD><PAD><PAD><PAD><PAD><PAD><PAD><PAD><PAD><PAD><PAD><PAD><PAD><PAD><PAD><PAD><PAD><PAD><PAD><PAD><PAD><PAD><PAD><PAD><PAD><PAD><PAD><PAD><PAD><PAD><PAD><PAD><PAD><PAD><PAD>
<CLS>CN(C)C1=CC=C(C=C1)C=NNC2=CC=C(C=C2)[N+](=O)[O-]<SEP>CCCCCCCCCCCCCCCCCCCCCCCCCCCCCCCCCCCCCCCCCCCCCCCCCCC	<CLS>CC(C)C1=CC=C(C=C1)C=NNC2=CC=C(C=C2)[N+](=O)[O-]<SEP><PAD><PAD><PAD><PAD><PAD><PAD><PAD><PAD><PAD><PAD><PAD><PAD><PAD><PAD><PAD><PAD><PAD><PAD><PAD><PAD><PAD><PAD><PAD><PAD><PAD><PAD><PAD><PAD><PAD><PAD><PAD><PAD><PAD><PAD><PAD><PAD><PAD><PAD><PAD><PAD><PAD><PAD><PAD><PAD><PAD><PAD><PAD><PAD><PAD><PAD><PAD>
<CLS>CCOC1=C(C=CC(=C1)C2C(=C(C(=O)N2C3=NC4=C(S3)C=C((=C4)F)O)C(=O)CCCCC=CS5COCCC=CCCCC=C6<SEP>CCCCCCCCCCCCCC	<CLS>CCOC1=C(C=CC(=C1)C2C(=C(C(=O)N2C3=NC4=C(S3)C=C(C=C4)F)O)C(=O)C5=CC=CS5)OCC6=CC=CC=C6<SEP><PAD><PAD><PAD><PAD><PAD><PAD><PAD><PAD><PAD><PAD><PAD><PAD><PAD><PAD>
<CLS>CCCCC1=C(N(N=C1C)C2=NC3=C(C4=CC=CC=C4N3)C5=CC=CC=C5)N=N5)C<SEP>CCCCCCCCCCCCCCCCCCCCCCCCCCCCCCCCCCCCCCCC	<CLS>CCCCC1=C(N(N=C1C)C2=NC3=C(C4=CC=CC=C4N3CC5=CC=CC=C5)N=N2)C<SEP><PAD><PAD><PAD><PAD><PAD><PAD><PAD><PAD><PAD><PAD><PAD><PAD><PAD><PAD><PAD><PAD><PAD><PAD><PAD><PAD><PAD><PAD><PAD><PAD><PAD><PAD><PAD><PAD><PAD><PAD><PAD><PAD><PAD><PAD><PAD><PAD><PAD><PAD><PAD><PAD>
<CLS>CCCOC1=CC=C(C=C1)C(=C2C(N(C(=O)C2=O)C3=NC4=C(S3)C=C(C=C4)OC)C5=CC(=C(CCC5)OCCCC)C<SEP>CCCCCCCCCCCCCCCCC	<CLS>CCCOC1=CC=C(C=C1)C(=C2C(N(C(=O)C2=O)C3=NC4=C(S3)C=C(C=C4)OC)C5=CC(=C(C=C5)OC)OC)O<SEP><PAD><PAD><PAD><PAD><PAD><PAD><PAD><PAD><PAD><PAD><PAD><PAD><PAD><PAD><PAD><PAD><PAD>
<CLS>CC1=C(SC(=C1C(=O)OC)NC(=S)NC2=NOC(=C2)C(C)(C)C)C<SEP>CCCCCCCCCCCCCCCCCCCCCCCCCCCCCCCCCCCCCCCCCCCCCCCCCC	<CLS>CC1=C(SC(=C1C(=O)OC)NC(=S)NC2=NOC(=C2)C(C)(C)C)C<SEP><PAD><PAD><PAD><PAD><PAD><PAD><PAD><PAD><PAD><PAD><PAD><PAD><PAD><PAD><PAD><PAD><PAD><PAD><PAD><PAD><PAD><PAD><PAD><PAD><PAD><PAD><PAD><PAD><PAD><PAD><PAD><PAD><PAD><PAD><PAD><PAD><PAD><PAD><PAD><PAD><PAD><PAD><PAD><PAD><PAD><PAD><PAD><PAD><PAD><PAD>
<CLS>CS(=O)(=O)NC1=CC(=NN1C2CCS(=O)(=O)C2)C3=CC=C(C=C3)F<SEP>CCCCCCCCCCCCCCCCCCCCCCCCCCCCCCCCCCCCCCCCCCCCCCC	<CLS>CS(=O)(=O)NC1=CC(=NN1C2CCS(=O)(=O)C2)C3=CC=C(C=C3)F<SEP><PAD><PAD><PAD><PAD><PAD><PAD><PAD><PAD><PAD><PAD><PAD><PAD><PAD><PAD><PAD><PAD><PAD><PAD><PAD><PAD><PAD><PAD><PAD><PAD><PAD><PAD><PAD><PAD><PAD><PAD><PAD><PAD><PAD><PAD><PAD><PAD><PAD><PAD><PAD><PAD><PAD><PAD><PAD><PAD><PAD><PAD><PAD>
<CLS>CCCCCOC(=O)C1=C(C=CC1)C(=O)N(C2=CC(=C(C=C2F)Cl)SCCC)C(=O)OC)C(=CCC<SEP>CCCCCCCCCCCCCCCCCCCCCCCCCCCCCCCC	<CLS>CCCCCOC(=O)C1=C(CCCC1)C(=O)N(C2=CC(=C(C=C2F)Cl)SC(C)C(=O)OC)C(=O)C<SEP><PAD><PAD><PAD><PAD><PAD><PAD><PAD><PAD><PAD><PAD><PAD><PAD><PAD><PAD><PAD><PAD><PAD><PAD><PAD><PAD><PAD><PAD><PAD><PAD><PAD><PAD><PAD><PAD><PAD><PAD><PAD><PAD>
<CLS>CC(C1=CC=C(S1)C(=O)C2=CC=CC=C2)C(=O)NCC3=C(C=CC5=C3CCC6=C5C4=C(C=C6)C=CC<SEP>CCCCCCCCCCCCCCCCCCCCCCCCCC	<CLS>CC(C1=CC=C(S1)C(=O)C2=CC=CC=C2)C(=O)NCC3=C4C=CC5=CC=CC6=C5C4=C(C=C6)C=C3<SEP><PAD><PAD><PAD><PAD><PAD><PAD><PAD><PAD><PAD><PAD><PAD><PAD><PAD><PAD><PAD><PAD><PAD><PAD><PAD><PAD><PAD><PAD><PAD><PAD><PAD><PAD>
<CLS>CC(=C)C(=O)NC1=CC=C(C=C1)C(=O)NS(=O)(=O)C<SEP>CCCCCCCCCCCCCCCCCCCCCCCCCCCCCCCCCCCCCCCCCCCCCCCCCCCCCCCCC	<CLS>CC(=C)C(=O)NC1=CC=C(C=C1)C(=O)NS(=O)(=O)N<SEP><PAD><PAD><PAD><PAD><PAD><PAD><PAD><PAD><PAD><PAD><PAD><PAD><PAD><PAD><PAD><PAD><PAD><PAD><PAD><PAD><PAD><PAD><PAD><PAD><PAD><PAD><PAD><PAD><PAD><PAD><PAD><PAD><PAD><PAD><PAD><PAD><PAD><PAD><PAD><PAD><PAD><PAD><PAD><PAD><PAD><PAD><PAD><PAD><PAD><PAD><PAD><PAD><PAD><PAD><PAD><PAD><PAD>
<CLS>CCCC1=NN2C(=O)C(=(N=C2S1)COC3=CC=C(C=C3)NC(=O)COC4=CC(=C(C=C4)C)C<SEP>CCCCCCCCCCCCCCCCCCCCCCCCCCCCCCCCC	<CLS>CCCC1=NN2C(=O)C=C(N=C2S1)COC3=CC=C(C=C3)NC(=O)COC4=CC(=C(C=C4)C)C<SEP><PAD><PAD><PAD><PAD><PAD><PAD><PAD><PAD><PAD><PAD><PAD><PAD><PAD><PAD><PAD><PAD><PAD><PAD><PAD><PAD><PAD><PAD><PAD><PAD><PAD><PAD><PAD><PAD><PAD><PAD><PAD><PAD><PAD>
<CLS>CCOC1=CC=CC=C1NC2=NN=C(S2)SC(C)C3=NN=C(O3)C4=CC=CC=C4<SEP>CCCCCCCCCCCCCCCCCCCCCCCCCCCCCCCCCCCCCCCCCCCCC	<CLS>CCOC1=CC=CC=C1NC2=NN=C(S2)SC(C)C3=NN=C(O3)C4=CC=CC=C4<SEP><PAD><PAD><PAD><PAD><PAD><PAD><PAD><PAD><PAD><PAD><PAD><PAD><PAD><PAD><PAD><PAD><PAD><PAD><PAD><PAD><PAD><PAD><PAD><PAD><PAD><PAD><PAD><PAD><PAD><PAD><PAD><PAD><PAD><PAD><PAD><PAD><PAD><PAD><PAD><PAD><PAD><PAD><PAD><PAD><PAD>
<CLS>CCCCCOC1=CC(=C(C(=C1)CCCCC)S(=O)(=O)O)C(=O)O)C(=O)O<SEP>CCCCCCCCCCCCCCCCCCCCCCCCCCCCCCCCCCCCCCCCCCCCCCC	<CLS>CCCCCCC1=CC(=C(C(=C1CCCCCC)S(=O)(=O)O)C(=O)O)C(=O)O<SEP><PAD><PAD><PAD><PAD><PAD><PAD><PAD><PAD><PAD><PAD><PAD><PAD><PAD><PAD><PAD><PAD><PAD><PAD><PAD><PAD><PAD><PAD><PAD><PAD><PAD><PAD><PAD><PAD><PAD><PAD><PAD><PAD><PAD><PAD><PAD><PAD><PAD><PAD><PAD><PAD><PAD><PAD><PAD><PAD><PAD><PAD><PAD>
<CLS>COC1=CC2=C(C=C1)N(CC2)CC3=C(N(C(=O)S3)C(CC(CC)C)C(=O)O)O<SEP>CCCCCCCCCCCCCCCCCCCCCCCCCCCCCCCCCCCCCCCCCC	<CLS>COC1=CC2=C(C=C1)N=CC2=CC3=C(N(C(=S)S3)C(CC(=O)O)C(=O)O)O<SEP><PAD><PAD><PAD><PAD><PAD><PAD><PAD><PAD><PAD><PAD><PAD><PAD><PAD><PAD><PAD><PAD><PAD><PAD><PAD><PAD><PAD><PAD><PAD><PAD><PAD><PAD><PAD><PAD><PAD><PAD><PAD><PAD><PAD><PAD><PAD><PAD><PAD><PAD><PAD><PAD><PAD><PAD>
<CLS>CC1=C(C(=NO1)C(=O)NC2=CN(C=N2)CC3=C(C=CC=C3Cl)Cl)COC4=CC=C(C=C4)F<SEP>CCCCCCCCCCCCCCCCCCCCCCCCCCCCCCCCC	<CLS>CC1=C(C(=NO1)C(=O)NC2=NN(C=N2)CC3=C(C=CC=C3Cl)Cl)COC4=CC=C(C=C4)F<SEP><PAD><PAD><PAD><PAD><PAD><PAD><PAD><PAD><PAD><PAD><PAD><PAD><PAD><PAD><PAD><PAD><PAD><PAD><PAD><PAD><PAD><PAD><PAD><PAD><PAD><PAD><PAD><PAD><PAD><PAD><PAD><PAD><PAD>
<CLS>CCN1C(=NC2=C(C=CC(=C21)C(=O)NCC3=C(C(=CC=C3)F)F)NS(=O)(=O)C4=CC=CC=C4)C<SEP>CCCCCCCCCCCCCCCCCCCCCCCCCCC	<CLS>CCN1C(=NC2=CC(=CC(=C21)C(=O)NCC3=C(C(=CC=C3)F)F)NS(=O)(=O)C4=CC=CC=C4)C<SEP><PAD><PAD><PAD><PAD><PAD><PAD><PAD><PAD><PAD><PAD><PAD><PAD><PAD><PAD><PAD><PAD><PAD><PAD><PAD><PAD><PAD><PAD><PAD><PAD><PAD><PAD><PAD>
<CLS>C1CN2CC1CN3CCC(C3)C2<SEP>CCCCCCCCCCCCCCCCCCCCCCCCCCCCCCCCCCCCCCCCCCCCCCCCCCCCCCCCCCCCCCCCCCCCCCCCCCCCCC	<CLS>C1CN2CN1CN3CCN(C3)C2<SEP><PAD><PAD><PAD><PAD><PAD><PAD><PAD><PAD><PAD><PAD><PAD><PAD><PAD><PAD><PAD><PAD><PAD><PAD><PAD><PAD><PAD><PAD><PAD><PAD><PAD><PAD><PAD><PAD><PAD><PAD><PAD><PAD><PAD><PAD><PAD><PAD><PAD><PAD><PAD><PAD><PAD><PAD><PAD><PAD><PAD><PAD><PAD><PAD><PAD><PAD><PAD><PAD><PAD><PAD><PAD><PAD><PAD><PAD><PAD><PAD><PAD><PAD><PAD><PAD><PAD><PAD><PAD><PAD><PAD><PAD><PAD><PAD><PAD><PAD><PAD><PAD><PAD><PAD>
<CLS>CC1=C(C=CC(=C1)Cl)N2CC2CC34C(C(C(O3)C(CC(C(=O)N(C5NC(=O)C6=CC=CC=C6)C6=O)N(C4C2=C)CCCCC<SEP>CCCCCCCCCCC	<CLS>CC1=C(C(=CC=C1)Cl)N2CC=CC34C(C5C(O3)C=CCCC(=O)NCC(OC5=O)C6=CC=CC=C6)C(=O)N(C4C2=O)CCCCO<SEP><PAD><PAD><PAD><PAD><PAD><PAD><PAD><PAD><PAD><PAD><PAD>
<CLS>CCNC(=O)C(C)NC(=O)CNC(=O)C1=CSC(=N1)C2=CC=C(C=C2)OC<SEP>CCCCCCCCCCCCCCCCCCCCCCCCCCCCCCCCCCCCCCCCCCCCCCC	<CLS>CCNC(=O)C(C)NC(=O)COC(=O)C1=CSC(=N1)C2=CC=C(C=C2)OC<SEP><PAD><PAD><PAD><PAD><PAD><PAD><PAD><PAD><PAD><PAD><PAD><PAD><PAD><PAD><PAD><PAD><PAD><PAD><PAD><PAD><PAD><PAD><PAD><PAD><PAD><PAD><PAD><PAD><PAD><PAD><PAD><PAD><PAD><PAD><PAD><PAD><PAD><PAD><PAD><PAD><PAD><PAD><PAD><PAD><PAD><PAD><PAD>
<CLS>CC(C)(C)C(C(C1=CC=C(C=C1)OC)(C2=CC=C(C=C2)OC)O)NC(=O)C(=O)NC(C(C)(C)C(C)C3=CC=C(C=C3)OC)OC4=CC=C(C<SEP>	<CLS>CC(C)(C)C(C(C1=CC=C(C=C1)OC)(C2=CC=C(C=C2)OC)O)NC(=O)C(=O)NC(C(C)(C)C)C(C3=CC=C(C=C3)OC)(C4=CC=C(C<SEP>
<CLS>CC1=C(N(N=C1C2=NN=NN2C3CC3)C4=C(C=C(C=C4)Cl)Cl)C5=CC=C(C=C5)Cl<SEP>CCCCCCCCCCCCCCCCCCCCCCCCCCCCCCCCCCCC	<CLS>CC1=C(N(N=C1C2=NN=NN2C3CC3)C4=C(C=C(C=C4)Cl)Cl)C5=CC=C(C=C5)Cl<SEP><PAD><PAD><PAD><PAD><PAD><PAD><PAD><PAD><PAD><PAD><PAD><PAD><PAD><PAD><PAD><PAD><PAD><PAD><PAD><PAD><PAD><PAD><PAD><PAD><PAD><PAD><PAD><PAD><PAD><PAD><PAD><PAD><PAD><PAD><PAD><PAD>
<CLS>COC1=C(C(=CC(=C1)C=CC(=O)O)S(=O)(=O)NC2CCCC2)OC<SEP>CCCCCCCCCCCCCCCCCCCCCCCCCCCCCCCCCCCCCCCCCCCCCCCCCCC	<CLS>COC1=C(C(=CC(=C1)C=CC(=O)O)S(=O)(=O)NC2CCCC2)OC<SEP><PAD><PAD><PAD><PAD><PAD><PAD><PAD><PAD><PAD><PAD><PAD><PAD><PAD><PAD><PAD><PAD><PAD><PAD><PAD><PAD><PAD><PAD><PAD><PAD><PAD><PAD><PAD><PAD><PAD><PAD><PAD><PAD><PAD><PAD><PAD><PAD><PAD><PAD><PAD><PAD><PAD><PAD><PAD><PAD><PAD><PAD><PAD><PAD><PAD><PAD><PAD>
<CLS>CC(C)(C)CCNC(=O)NC1=C(C=C(C=C1)OC2=C3C=C(C(=CC3=NC=C2)C)CN4CCCCC4)OC)Cl<SEP>CCCCCCCCCCCCCCCCCCCCCCCCCCC	<CLS>CC(C)(C)CCNC(=O)NC1=C(C=C(C=C1)OC2=C3C=C(C(=CC3=NC=C2)OCCN4CCCCC4)OC)Cl<SEP><PAD><PAD><PAD><PAD><PAD><PAD><PAD><PAD><PAD><PAD><PAD><PAD><PAD><PAD><PAD><PAD><PAD><PAD><PAD><PAD><PAD><PAD><PAD><PAD><PAD><PAD><PAD>
<CLS>CC1C(=O)N(CCN1CC2=C(OC(=N2)C3=CC(=C(C=C3)OC)C)C)C<SEP>CCCCCCCCCCCCCCCCCCCCCCCCCCCCCCCCCCCCCCCCCCCCCCCCC	<CLS>CC1C(=O)N(CCN1CC2=C(OC(=N2)C3=CC(=C(C=C3)OC)C)C)C<SEP><PAD><PAD><PAD><PAD><PAD><PAD><PAD><PAD><PAD><PAD><PAD><PAD><PAD><PAD><PAD><PAD><PAD><PAD><PAD><PAD><PAD><PAD><PAD><PAD><PAD><PAD><PAD><PAD><PAD><PAD><PAD><PAD><PAD><PAD><PAD><PAD><PAD><PAD><PAD><PAD><PAD><PAD><PAD><PAD><PAD><PAD><PAD><PAD><PAD>
<CLS>CC1=C((=C(O1)C2=C(N=C(C=C2)C3=NC(=CS3)C(=O)O)C4=CSC(=N4)C5=CSC(=NC)C(C(C)CC(OC6=CC=CC=CCCOCC=CC=CC<SEP>	<CLS>CC1=C(N=C(O1)C2=C(N=C(C=C2)C3=NC(=CS3)C(=O)O)C4=CSC(=N4)C5=CSC(=N5)C(C(C)CC(OC6=CC=CC=C6)OC7=CC=CC<SEP>
<CLS>C1=C(C=C(C=C1C(F)(F)F)N=C(N)N)C(=O)NCC(=O)NC(CC(=O)O)C2=CC(=C(C=C2)Cl)OC3C(C(C(C(O3)Cl)O)O)O<SEP>CC<SEP>CCC	<CLS>C1=C(C=C(C=C1C(F)(F)F)N=C(N)N)C(=O)NCC(=O)NC(CC(=O)O)C2=CC(=C(C=C2O)O)OC3C(C(C(C(O3)CO)O)O)O<SEP><PAD><PAD><PAD><PAD><PAD><PAD>
<CLS>CC(=O)OC(C12CC2C(O1)(C3C2C(=O)N(C3=O)C4=CC(=CC=C4)[N+](=O)[O-])C)OC(=O)C<SEP>CCCCCCCCCCCCCCCCCCCCCCCCCC	<CLS>CC(=O)OC(C12C=CC(O1)(C3C2C(=O)N(C3=O)C4=CC(=CC=C4)[N+](=O)[O-])C)OC(=O)C<SEP><PAD><PAD><PAD><PAD><PAD><PAD><PAD><PAD><PAD><PAD><PAD><PAD><PAD><PAD><PAD><PAD><PAD><PAD><PAD><PAD><PAD><PAD><PAD><PAD><PAD><PAD>
<CLS>COC1=CC=C(C=C1)NC(=O)CN2CCN(CC2)C3=CC=CC=C3<SEP>CCCCCCCCCCCCCCCCCCCCCCCCCCCCCCCCCCCCCCCCCCCCCCCCCCCCCCC	<CLS>CCC1=CC=C(C=C1)NC(=O)CN2CCN(CC2)C3=CC=CC=C3<SEP><PAD><PAD><PAD><PAD><PAD><PAD><PAD><PAD><PAD><PAD><PAD><PAD><PAD><PAD><PAD><PAD><PAD><PAD><PAD><PAD><PAD><PAD><PAD><PAD><PAD><PAD><PAD><PAD><PAD><PAD><PAD><PAD><PAD><PAD><PAD><PAD><PAD><PAD><PAD><PAD><PAD><PAD><PAD><PAD><PAD><PAD><PAD><PAD><PAD><PAD><PAD><PAD><PAD><PAD><PAD>
<CLS>CC1=C(C=C(C=C1)C2=CC=C(O2)C(=O)NC(=S)NC3=CC=C(C=C3)N4CCCCCC4)C5=C(CC=C(C(=C5FCFCFCFCCCCl<SEP>CCCCCCCCCC	<CLS>CC1=C(C=C(C=C1)C2=CC=C(O2)C(=O)NC(=S)NC3=CC=C(C=C3)N4CCN(CC4)C5=C(C(=C(C(=C5F)F)F)F)F)Cl<SEP><PAD><PAD><PAD><PAD><PAD><PAD><PAD><PAD><PAD><PAD>
<CLS>CC1=C(C2=C(N1C(=O)C3=CC=C(C=C3)F)C=CC(=C2)OC)CC(=O)O)C(=O)O<SEP>CCCCCCCCCCCCCCCCCCCCCCCCCCCCCCCCCCCCCCC	<CLS>CC1=C(C2=C(N1C(=O)C3=CC=C(C=C3)F)C=CC(=C2)OC)CC(=O)OCC(=O)O<SEP><PAD><PAD><PAD><PAD><PAD><PAD><PAD><PAD><PAD><PAD><PAD><PAD><PAD><PAD><PAD><PAD><PAD><PAD><PAD><PAD><PAD><PAD><PAD><PAD><PAD><PAD><PAD><PAD><PAD><PAD><PAD><PAD><PAD><PAD><PAD><PAD><PAD><PAD><PAD>
<CLS>CC(CNC(=O)C1=CC=C(C=C1)OCC(=O)N2CC(=O)NC3=CC=CC=C32<SEP>CCCCCCCCCCCCCCCCCCCCCCCCCCCCCCCCCCCCCCCCCCCCCCC	<CLS>CCCCOC(=O)C1=CC=C(C=C1)OCC(=O)N2CC(=O)NC3=CC=CC=C32<SEP><PAD><PAD><PAD><PAD><PAD><PAD><PAD><PAD><PAD><PAD><PAD><PAD><PAD><PAD><PAD><PAD><PAD><PAD><PAD><PAD><PAD><PAD><PAD><PAD><PAD><PAD><PAD><PAD><PAD><PAD><PAD><PAD><PAD><PAD><PAD><PAD><PAD><PAD><PAD><PAD><PAD><PAD><PAD><PAD><PAD><PAD><PAD>
<CLS>COC(=O)CCCCC(=O)[O-].[Cl-]<SEP>CCCCCCCCCCCCCCCCCCCCCCCCCCCCCCCCCCCCCCCCCCCCCCCCCCCCCCCCCCCCCCCCCCCCCCCC	<CLS>COC(=O)CCCCC(=O)[O-].[Cl-]<SEP><PAD><PAD><PAD><PAD><PAD><PAD><PAD><PAD><PAD><PAD><PAD><PAD><PAD><PAD><PAD><PAD><PAD><PAD><PAD><PAD><PAD><PAD><PAD><PAD><PAD><PAD><PAD><PAD><PAD><PAD><PAD><PAD><PAD><PAD><PAD><PAD><PAD><PAD><PAD><PAD><PAD><PAD><PAD><PAD><PAD><PAD><PAD><PAD><PAD><PAD><PAD><PAD><PAD><PAD><PAD><PAD><PAD><PAD><PAD><PAD><PAD><PAD><PAD><PAD><PAD><PAD><PAD><PAD><PAD><PAD><PAD><PAD>
<CLS>CC1=CC=C(C=C1)CC2C(=O)C2CC3N2C(=O)C(N3S(=O)(=O)C4=CC=C(C=C4)ClCCCC(=C)O)CCC(=O)O<SEP>CCCCCCCCCCCCCCCCCC	<CLS>CC1=CC=C(C=C1)CC2C(=O)N(CC3N2C(=O)C(N3S(=O)(=O)C4=CC=C(C=C4)Cl)CCC(=O)O)CCC(=O)O<SEP><PAD><PAD><PAD><PAD><PAD><PAD><PAD><PAD><PAD><PAD><PAD><PAD><PAD><PAD><PAD><PAD><PAD><PAD>
<CLS>CCOC1=C(C(=CC(=C1)C=C2C(CCCC[NH+]2CC2)C)Br)OC<SEP>CCCCCCCCCCCCCCCCCCCCCCCCCCCCCCCCCCCCCCCCCCCCCCCCCCCCC	<CLS>CCOC1=C(C(=CC(=C1)C=C2C(C3CC[NH+]2CC3)O)Br)OC<SEP><PAD><PAD><PAD><PAD><PAD><PAD><PAD><PAD><PAD><PAD><PAD><PAD><PAD><PAD><PAD><PAD><PAD><PAD><PAD><PAD><PAD><PAD><PAD><PAD><PAD><PAD><PAD><PAD><PAD><PAD><PAD><PAD><PAD><PAD><PAD><PAD><PAD><PAD><PAD><PAD><PAD><PAD><PAD><PAD><PAD><PAD><PAD><PAD><PAD><PAD><PAD><PAD><PAD>
<CLS>CCC(C1=CC=C(C=C1)OC)NC(=O)C=CC2=CC=CC(=C2OC<SEP>CCCCCCCCCCCCCCCCCCCCCCCCCCCCCCCCCCCCCCCCCCCCCCCCCCCCCCC	<CLS>CCC(C1=CC=C(C=C1)OC)NC(=O)CSCC2=CC=CC(=C2)C<SEP><PAD><PAD><PAD><PAD><PAD><PAD><PAD><PAD><PAD><PAD><PAD><PAD><PAD><PAD><PAD><PAD><PAD><PAD><PAD><PAD><PAD><PAD><PAD><PAD><PAD><PAD><PAD><PAD><PAD><PAD><PAD><PAD><PAD><PAD><PAD><PAD><PAD><PAD><PAD><PAD><PAD><PAD><PAD><PAD><PAD><PAD><PAD><PAD><PAD><PAD><PAD><PAD><PAD><PAD><PAD>
<CLS>CC(C(=O)NC1=CC=C(C=C1)NS(=O)(=O)C)OC2=CC(=CC=C2)Cl<SEP>CCCCCCCCCCCCCCCCCCCCCCCCCCCCCCCCCCCCCCCCCCCCCCCC	<CLS>CC(C(=O)NC1=CC=C(C=C1)NS(=O)(=O)C)OC2=CC(=CC=C2)Cl<SEP><PAD><PAD><PAD><PAD><PAD><PAD><PAD><PAD><PAD><PAD><PAD><PAD><PAD><PAD><PAD><PAD><PAD><PAD><PAD><PAD><PAD><PAD><PAD><PAD><PAD><PAD><PAD><PAD><PAD><PAD><PAD><PAD><PAD><PAD><PAD><PAD><PAD><PAD><PAD><PAD><PAD><PAD><PAD><PAD><PAD><PAD><PAD><PAD>
<CLS>CC(=NO)C(C)(C)NCC(=NC(C)(CNC(=NC)CCN1C=CN=C1[N+](=O)[O-])(F)F<SEP>CCCCCCCCCCCCCCCCCCCCCCCCCCCCCCCCCCCCC	<CLS>CC(=NO)C(C)(C)NCC(CNC(C)(C)C(=NO)CCN1C=CN=C1[N+](=O)[O-])(F)F<SEP><PAD><PAD><PAD><PAD><PAD><PAD><PAD><PAD><PAD><PAD><PAD><PAD><PAD><PAD><PAD><PAD><PAD><PAD><PAD><PAD><PAD><PAD><PAD><PAD><PAD><PAD><PAD><PAD><PAD><PAD><PAD><PAD><PAD><PAD><PAD><PAD><PAD>
<CLS>COC(=O)C1=CC=C(C=C1)C2C(=C(C(=O)N2C3=NN=C(S3)SCC4=CC=C(C=C4)Cl)O)C(=O)CC=CC6CCCCCC=C6C5<SEP>CCCCCCCCCCC	<CLS>COC(=O)C1=CC=C(C=C1)C2C(=C(C(=O)N2C3=NN=C(S3)SCC4=CC=C(C=C4)Cl)O)C(=O)C5=CC6=CC=CC=C6O5<SEP><PAD><PAD><PAD><PAD><PAD><PAD><PAD><PAD><PAD><PAD><PAD>
<CLS>CC(C(=O)NC1=CC=C(C=C1)OCC2=CC=CC=C2)SC3=NN=C(N3N)C4CCCCC4<SEP>CCCCCCCCCCCCCCCCCCCCCCCCCCCCCCCCCCCCCCCCC	<CLS>CC(C(=O)NC1=CC=C(C=C1)OCC2=CC=CC=C2)SC3=NN=C(N3N)C4CCCCC4<SEP><PAD><PAD><PAD><PAD><PAD><PAD><PAD><PAD><PAD><PAD><PAD><PAD><PAD><PAD><PAD><PAD><PAD><PAD><PAD><PAD><PAD><PAD><PAD><PAD><PAD><PAD><PAD><PAD><PAD><PAD><PAD><PAD><PAD><PAD><PAD><PAD><PAD><PAD><PAD><PAD><PAD>
<CLS>COC1=CC=C(C=C1)C(=O)NC2=CC=C(C=C2)C(=O)NNC(=S)NC3CCCCC3<SEP>CCCCCCCCCCCCCCCCCCCCCCCCCCCCCCCCCCCCCCCCCCC	<CLS>COC1=CC=C(C=C1)C(=O)NC2=CC=C(C=C2)C(=O)NNC(=S)NC3CCCCC3<SEP><PAD><PAD><PAD><PAD><PAD><PAD><PAD><PAD><PAD><PAD><PAD><PAD><PAD><PAD><PAD><PAD><PAD><PAD><PAD><PAD><PAD><PAD><PAD><PAD><PAD><PAD><PAD><PAD><PAD><PAD><PAD><PAD><PAD><PAD><PAD><PAD><PAD><PAD><PAD><PAD><PAD><PAD><PAD>
<CLS>CCOC(=O)C1=C(SC(=C1C)C(=O)OC)NC(=O)CN2C(=CSC2=O)C<SEP>CCCCCCCCCCCCCCCCCCCCCCCCCCCCCCCCCCCCCCCCCCCCCCCCC	<CLS>CCOC(=O)C1=C(SC(=C1C)C(=O)NC)NC(=O)CN2C(=CSC2=O)C<SEP><PAD><PAD><PAD><PAD><PAD><PAD><PAD><PAD><PAD><PAD><PAD><PAD><PAD><PAD><PAD><PAD><PAD><PAD><PAD><PAD><PAD><PAD><PAD><PAD><PAD><PAD><PAD><PAD><PAD><PAD><PAD><PAD><PAD><PAD><PAD><PAD><PAD><PAD><PAD><PAD><PAD><PAD><PAD><PAD><PAD><PAD><PAD><PAD><PAD>
<CLS>CCCCCCCCCCCCC(CCCCCCN(CC(CCCCCCCCC)O)C(C)C)C(C(C)C<SEP>CCCCCCCCCCCCCCCCCCCCCCCCCCCCCCCCCCCCCCCCCCCCCCCC	<CLS>CCCCCCCCCC(CN(CCCCCCN(CC(CCCCCCCCC)O)C(C)C)C(C)C)O<SEP><PAD><PAD><PAD><PAD><PAD><PAD><PAD><PAD><PAD><PAD><PAD><PAD><PAD><PAD><PAD><PAD><PAD><PAD><PAD><PAD><PAD><PAD><PAD><PAD><PAD><PAD><PAD><PAD><PAD><PAD><PAD><PAD><PAD><PAD><PAD><PAD><PAD><PAD><PAD><PAD><PAD><PAD><PAD><PAD><PAD><PAD><PAD><PAD>
<CLS>C1=CC(=NC=C1CN2C=NC=N2)Cl<SEP>CCCCCCCCCCCCCCCCCCCCCCCCCCCCCCCCCCCCCCCCCCCCCCCCCCCCCCCCCCCCCCCCCCCCCCCCC	<CLS>C1=CC(=NC=C1CN2C=NC=N2)Cl<SEP><PAD><PAD><PAD><PAD><PAD><PAD><PAD><PAD><PAD><PAD><PAD><PAD><PAD><PAD><PAD><PAD><PAD><PAD><PAD><PAD><PAD><PAD><PAD><PAD><PAD><PAD><PAD><PAD><PAD><PAD><PAD><PAD><PAD><PAD><PAD><PAD><PAD><PAD><PAD><PAD><PAD><PAD><PAD><PAD><PAD><PAD><PAD><PAD><PAD><PAD><PAD><PAD><PAD><PAD><PAD><PAD><PAD><PAD><PAD><PAD><PAD><PAD><PAD><PAD><PAD><PAD><PAD><PAD><PAD><PAD><PAD><PAD><PAD>
<CLS>CC(C)(C)C(=O)NCC(C1=CC=CS1)[NH+]2CCOCC2<SEP>CCCCCCCCCCCCCCCCCCCCCCCCCCCCCCCCCCCCCCCCCCCCCCCCCCCCCCCCCCC	<CLS>CC(C)(C)C(=O)NCC(C1=CC=CS1)[NH+]2CCOCC2<SEP><PAD><PAD><PAD><PAD><PAD><PAD><PAD><PAD><PAD><PAD><PAD><PAD><PAD><PAD><PAD><PAD><PAD><PAD><PAD><PAD><PAD><PAD><PAD><PAD><PAD><PAD><PAD><PAD><PAD><PAD><PAD><PAD><PAD><PAD><PAD><PAD><PAD><PAD><PAD><PAD><PAD><PAD><PAD><PAD><PAD><PAD><PAD><PAD><PAD><PAD><PAD><PAD><PAD><PAD><PAD><PAD><PAD><PAD><PAD>
<CLS>CCN(CC)CCCCCC(CC)CC.CC(=O)OC1C(OC(C1O)O)COP(=O)(O)OP(=O)(O)OCC(C(C(C(O2)N3C=CC4=C(N=CN=C4)CO)O)O<SEP>CC	<CLS>CCN(CC)CC.CCN(CC)CC.CC(=O)NC1C(OC(C1O)O)COP(=O)(O)OP(=O)(O)OCC2C(C(C(O2)N3C=NC4=C(N=CN=C43)N)O)O<SEP><PAD><PAD>
<CLS>CC1=CC=CC=C1N2C(=NN=C2SCC(=O)N3CCN(CC3)C4=CC=C(C=C4)F)C5=CC=CC=C5<SEP>CCCCCCCCCCCCCCCCCCCCCCCCCCCCCCCCC	<CLS>CC1=CC=CC=C1N2C(=NN=C2SCC(=O)N3CCN(CC3)C4=CC=C(C=C4)O)C5=CN=CC=C5<SEP><PAD><PAD><PAD><PAD><PAD><PAD><PAD><PAD><PAD><PAD><PAD><PAD><PAD><PAD><PAD><PAD><PAD><PAD><PAD><PAD><PAD><PAD><PAD><PAD><PAD><PAD><PAD><PAD><PAD><PAD><PAD><PAD><PAD>
<CLS>C1=CC(=CC=C1C(=O)O)CCC2=CC=C(C=C2)OC3=CC=C(C=C3)C(=O)O)(C(F)(F)F)C(F)(F)F<SEP>CCCCCCCCCCCCCCCCCCCCCCCCC	<CLS>C1=CC(=CC=C1C(=O)O)C(C2=CC=C(C=C2)OC3=CC=C(C=C3)C(=O)O)(C(F)(F)F)C(F)(F)F<SEP><PAD><PAD><PAD><PAD><PAD><PAD><PAD><PAD><PAD><PAD><PAD><PAD><PAD><PAD><PAD><PAD><PAD><PAD><PAD><PAD><PAD><PAD><PAD><PAD><PAD>
<CLS>CC1=CC2=C(C=C1)N=C(C(=[N+]2[O-])C3=CC=CC=C3)C4=CC=CC=C4<SEP>CCCCCCCCCCCCCCCCCCCCCCCCCCCCCCCCCCCCCCCCCCC	<CLS>CC1=CC2=C(C=C1)N=C(C(=[N+]2[O-])C3=CC=CC=C3)C4=CC=CC=C4<SEP><PAD><PAD><PAD><PAD><PAD><PAD><PAD><PAD><PAD><PAD><PAD><PAD><PAD><PAD><PAD><PAD><PAD><PAD><PAD><PAD><PAD><PAD><PAD><PAD><PAD><PAD><PAD><PAD><PAD><PAD><PAD><PAD><PAD><PAD><PAD><PAD><PAD><PAD><PAD><PAD><PAD><PAD><PAD>
<CLS>C1CC(NC1)C(=O)NCC(=O)NC(CO)C(=O)NC(CCCN=C(N)N)C(=O)O<SEP>CCCCCCCCCCCCCCCCCCCCCCCCCCCCCCCCCCCCCCCCCCCCCC	<CLS>C1CC(NC1)C(=O)NCC(=O)NC(CO)C(=O)NC(CCCN=C(N)N)C(=O)O<SEP><PAD><PAD><PAD><PAD><PAD><PAD><PAD><PAD><PAD><PAD><PAD><PAD><PAD><PAD><PAD><PAD><PAD><PAD><PAD><PAD><PAD><PAD><PAD><PAD><PAD><PAD><PAD><PAD><PAD><PAD><PAD><PAD><PAD><PAD><PAD><PAD><PAD><PAD><PAD><PAD><PAD><PAD><PAD><PAD><PAD><PAD>
<CLS>CC(=CC=CCC(=C)CCCC1(C)C)C=CC=C<SEP>CCCCCCCCCCCCCCCCCCCCCCCCCCCCCCCCCCCCCCCCCCCCCCCCCCCCCCCCCCCCCCCCCCCC	<CLS>CC(=CC=C1C(=C)CCCC1(C)C)C#CC=C<SEP><PAD><PAD><PAD><PAD><PAD><PAD><PAD><PAD><PAD><PAD><PAD><PAD><PAD><PAD><PAD><PAD><PAD><PAD><PAD><PAD><PAD><PAD><PAD><PAD><PAD><PAD><PAD><PAD><PAD><PAD><PAD><PAD><PAD><PAD><PAD><PAD><PAD><PAD><PAD><PAD><PAD><PAD><PAD><PAD><PAD><PAD><PAD><PAD><PAD><PAD><PAD><PAD><PAD><PAD><PAD><PAD><PAD><PAD><PAD><PAD><PAD><PAD><PAD><PAD><PAD><PAD><PAD><PAD>
<CLS>CC(=NNC(=O)C1CC1C2=CC=CC=C2)C3=CC=CC=C3Cl<SEP>CCCCCCCCCCCCCCCCCCCCCCCCCCCCCCCCCCCCCCCCCCCCCCCCCCCCCCCCC	<CLS>CC(=NNC(=O)C1CC1C2=CC=CC=C2)C3=CC=CC=C3Cl<SEP><PAD><PAD><PAD><PAD><PAD><PAD><PAD><PAD><PAD><PAD><PAD><PAD><PAD><PAD><PAD><PAD><PAD><PAD><PAD><PAD><PAD><PAD><PAD><PAD><PAD><PAD><PAD><PAD><PAD><PAD><PAD><PAD><PAD><PAD><PAD><PAD><PAD><PAD><PAD><PAD><PAD><PAD><PAD><PAD><PAD><PAD><PAD><PAD><PAD><PAD><PAD><PAD><PAD><PAD><PAD><PAD><PAD>
<CLS>C(C#CBr)OCN1C(=C(C=C1=l)Cl)Cl<SEP>CCCCCCCCCCCCCCCCCCCCCCCCCCCCCCCCCCCCCCCCCCCCCCCCCCCCCCCCCCCCCCCCCCCCC	<CLS>C(C#CBr)OCN1C(=C(N=C1Br)Cl)Cl<SEP><PAD><PAD><PAD><PAD><PAD><PAD><PAD><PAD><PAD><PAD><PAD><PAD><PAD><PAD><PAD><PAD><PAD><PAD><PAD><PAD><PAD><PAD><PAD><PAD><PAD><PAD><PAD><PAD><PAD><PAD><PAD><PAD><PAD><PAD><PAD><PAD><PAD><PAD><PAD><PAD><PAD><PAD><PAD><PAD><PAD><PAD><PAD><PAD><PAD><PAD><PAD><PAD><PAD><PAD><PAD><PAD><PAD><PAD><PAD><PAD><PAD><PAD><PAD><PAD><PAD><PAD><PAD><PAD><PAD>
<CLS>CC1=CC=C(C=C1)S(=O)(=O)N=C(C2=CC=CC=C2)OC(C(=O)OC)C(=O)OC<SEP>CCCCCCCCCCCCCCCCCCCCCCCCCCCCCCCCCCCCCCCCC	<CLS>CC1=CC=C(C=C1)S(=O)(=O)N=C(C2=CC=CC=C2)OC(C(=O)OC)C(=O)OC<SEP><PAD><PAD><PAD><PAD><PAD><PAD><PAD><PAD><PAD><PAD><PAD><PAD><PAD><PAD><PAD><PAD><PAD><PAD><PAD><PAD><PAD><PAD><PAD><PAD><PAD><PAD><PAD><PAD><PAD><PAD><PAD><PAD><PAD><PAD><PAD><PAD><PAD><PAD><PAD><PAD><PAD>
<CLS>CN(CC1=CC=C(C=C1)OCl)C(=O)NC2=C(C=CC(=C2)Cl)N3C=CC=N3<SEP>CCCCCCCCCCCCCCCCCCCCCCCCCCCCCCCCCCCCCCCCCCCCC	<CLS>CN(CC1=CC=C(C=C1)SC)CC(=O)NC2=C(C=CC(=C2)Cl)N3C=NC=N3<SEP><PAD><PAD><PAD><PAD><PAD><PAD><PAD><PAD><PAD><PAD><PAD><PAD><PAD><PAD><PAD><PAD><PAD><PAD><PAD><PAD><PAD><PAD><PAD><PAD><PAD><PAD><PAD><PAD><PAD><PAD><PAD><PAD><PAD><PAD><PAD><PAD><PAD><PAD><PAD><PAD><PAD><PAD><PAD><PAD><PAD>
<CLS>CC1=CC(=C(N1C2=CC=CC=C2)C)C(=O)NNC(=O)C3=CC=CC=C3)CC4=C(ON=C4C)C<SEP>CCCCCCCCCCCCCCCCCCCCCCCCCCCCCCCCCC	<CLS>CC1=CC(=C(N1C2=CC=CC=C2)C)C(=O)NNC(=O)C3=CC=CC=C3OCC4=C(ON=C4C)C<SEP><PAD><PAD><PAD><PAD><PAD><PAD><PAD><PAD><PAD><PAD><PAD><PAD><PAD><PAD><PAD><PAD><PAD><PAD><PAD><PAD><PAD><PAD><PAD><PAD><PAD><PAD><PAD><PAD><PAD><PAD><PAD><PAD><PAD><PAD>
<CLS>C1CCC(CC1)C(=O)NC2CCN(CC2)C3=C(N=C(O3)C4=CC=CS4)C#N<SEP>CCCCCCCCCCCCCCCCCCCCCCCCCCCCCCCCCCCCCCCCCCCCCCC	<CLS>C1CCN(CC1)C(=O)CN2CCN(CC2)C3=C(N=C(O3)C4=CC=CO4)C#N<SEP><PAD><PAD><PAD><PAD><PAD><PAD><PAD><PAD><PAD><PAD><PAD><PAD><PAD><PAD><PAD><PAD><PAD><PAD><PAD><PAD><PAD><PAD><PAD><PAD><PAD><PAD><PAD><PAD><PAD><PAD><PAD><PAD><PAD><PAD><PAD><PAD><PAD><PAD><PAD><PAD><PAD><PAD><PAD><PAD><PAD><PAD><PAD>
<CLS>CC(CC1=CC2=C(C=C1)C=C(C=C2)CC(C)O)O<SEP>CCCCCCCCCCCCCCCCCCCCCCCCCCCCCCCCCCCCCCCCCCCCCCCCCCCCCCCCCCCCCCC	<CLS>CC(CC1=CC2=C(C=C1)C=C(C=C2)CC(C)O)O<SEP><PAD><PAD><PAD><PAD><PAD><PAD><PAD><PAD><PAD><PAD><PAD><PAD><PAD><PAD><PAD><PAD><PAD><PAD><PAD><PAD><PAD><PAD><PAD><PAD><PAD><PAD><PAD><PAD><PAD><PAD><PAD><PAD><PAD><PAD><PAD><PAD><PAD><PAD><PAD><PAD><PAD><PAD><PAD><PAD><PAD><PAD><PAD><PAD><PAD><PAD><PAD><PAD><PAD><PAD><PAD><PAD><PAD><PAD><PAD><PAD><PAD><PAD><PAD>
<CLS>CC=CC=CC(CC1=CC=CC=C1)NCC2=CC=CC=C2<SEP>CCCCCCCCCCCCCCCCCCCCCCCCCCCCCCCCCCCCCCCCCCCCCCCCCCCCCCCCCCCCCCC	<CLS>CC=CC=CC(CC1=CC=CC=C1)NCC2=CC=CC=C2<SEP><PAD><PAD><PAD><PAD><PAD><PAD><PAD><PAD><PAD><PAD><PAD><PAD><PAD><PAD><PAD><PAD><PAD><PAD><PAD><PAD><PAD><PAD><PAD><PAD><PAD><PAD><PAD><PAD><PAD><PAD><PAD><PAD><PAD><PAD><PAD><PAD><PAD><PAD><PAD><PAD><PAD><PAD><PAD><PAD><PAD><PAD><PAD><PAD><PAD><PAD><PAD><PAD><PAD><PAD><PAD><PAD><PAD><PAD><PAD><PAD><PAD><PAD><PAD>
<CLS>CN1C=CC(=N1)NC(=O)C2CC(=O)N(C2)C3=CC4=C(C=C3)OCO4<SEP>CCCCCCCCCCCCCCCCCCCCCCCCCCCCCCCCCCCCCCCCCCCCCCCCC	<CLS>CN1C=CC(=N1)NC(=O)C2CC(=O)N(C2)C3=CC4=C(C=C3)OCO4<SEP><PAD><PAD><PAD><PAD><PAD><PAD><PAD><PAD><PAD><PAD><PAD><PAD><PAD><PAD><PAD><PAD><PAD><PAD><PAD><PAD><PAD><PAD><PAD><PAD><PAD><PAD><PAD><PAD><PAD><PAD><PAD><PAD><PAD><PAD><PAD><PAD><PAD><PAD><PAD><PAD><PAD><PAD><PAD><PAD><PAD><PAD><PAD><PAD><PAD>
<CLS>CC(C)N(CC=C([Si](C)(C)C)CCC=CC=CC=C1<SEP>CCCCCCCCCCCCCCCCCCCCCCCCCCCCCCCCCCCCCCCCCCCCCCCCCCCCCCCCCCCCCC	<CLS>CC(C)N=CC=C([Si](C)(C)C)SC1=CC=CC=C1<SEP><PAD><PAD><PAD><PAD><PAD><PAD><PAD><PAD><PAD><PAD><PAD><PAD><PAD><PAD><PAD><PAD><PAD><PAD><PAD><PAD><PAD><PAD><PAD><PAD><PAD><PAD><PAD><PAD><PAD><PAD><PAD><PAD><PAD><PAD><PAD><PAD><PAD><PAD><PAD><PAD><PAD><PAD><PAD><PAD><PAD><PAD><PAD><PAD><PAD><PAD><PAD><PAD><PAD><PAD><PAD><PAD><PAD><PAD><PAD><PAD><PAD><PAD>
<CLS>CC1=C(N=NC2=C(C(=NN12)C)C)C3=CC=C(C=C3)Cl)C(=O)NC4=CC=C(C=C4)F<SEP>CCCCCCCCCCCCCCCCCCCCCCCCCCCCCCCCCCCC	<CLS>CC1=C(N=NC2=C(C(=NN12)COC)C3=CC=C(C=C3)Cl)C(=O)NC4=CC=C(C=C4)F<SEP><PAD><PAD><PAD><PAD><PAD><PAD><PAD><PAD><PAD><PAD><PAD><PAD><PAD><PAD><PAD><PAD><PAD><PAD><PAD><PAD><PAD><PAD><PAD><PAD><PAD><PAD><PAD><PAD><PAD><PAD><PAD><PAD><PAD><PAD><PAD><PAD>
<CLS>COC1=C(C=C2C(=C1)NC(=O)NC2=O)C3CCCCC3<SEP>CCCCCCCCCCCCCCCCCCCCCCCCCCCCCCCCCCCCCCCCCCCCCCCCCCCCCCCCCCCCC	<CLS>COC1=CC(=C2C(=C1)NC(=O)NC2=O)C3CCOCC3<SEP><PAD><PAD><PAD><PAD><PAD><PAD><PAD><PAD><PAD><PAD><PAD><PAD><PAD><PAD><PAD><PAD><PAD><PAD><PAD><PAD><PAD><PAD><PAD><PAD><PAD><PAD><PAD><PAD><PAD><PAD><PAD><PAD><PAD><PAD><PAD><PAD><PAD><PAD><PAD><PAD><PAD><PAD><PAD><PAD><PAD><PAD><PAD><PAD><PAD><PAD><PAD><PAD><PAD><PAD><PAD><PAD><PAD><PAD><PAD><PAD><PAD>
<CLS>CCCCCCCCCCCCCCCCOCC(COCC1=CC=C(C=C1)C[N+]2=CC=CC=C2)OCC<SEP>CCCCCCCCCCCCCCCCCCCCCCCCCCCCCCCCCCCCCCCCCCC	<CLS>CCCCCCCCCCCCCCCCOCC(COCC1=CC=C(C=C1)C[N+]2=CC=CC=C2)OCC<SEP><PAD><PAD><PAD><PAD><PAD><PAD><PAD><PAD><PAD><PAD><PAD><PAD><PAD><PAD><PAD><PAD><PAD><PAD><PAD><PAD><PAD><PAD><PAD><PAD><PAD><PAD><PAD><PAD><PAD><PAD><PAD><PAD><PAD><PAD><PAD><PAD><PAD><PAD><PAD><PAD><PAD><PAD><PAD>
<CLS>CC(C)C1=CC=C(C=C1)C2=NC(=CS2)CN(C)CC(=O)NC3=CC=CC=C3C(F)(F)F<SEP>CCCCCCCCCCCCCCCCCCCCCCCCCCCCCCCCCCCCCC	<CLS>CC(C)C1=CC=C(C=C1)C2=NC(=CS2)CN(C)CC(=O)NC3=CC=CC=C3C(F)(F)F<SEP><PAD><PAD><PAD><PAD><PAD><PAD><PAD><PAD><PAD><PAD><PAD><PAD><PAD><PAD><PAD><PAD><PAD><PAD><PAD><PAD><PAD><PAD><PAD><PAD><PAD><PAD><PAD><PAD><PAD><PAD><PAD><PAD><PAD><PAD><PAD><PAD><PAD><PAD>
<CLS>C1=CC=C2C(=C1)C(=O)N(C2=O)NC(=O)C3=CC=CC=C3C(=O)O<SEP>CCCCCCCCCCCCCCCCCCCCCCCCCCCCCCCCCCCCCCCCCCCCCCCCC	<CLS>C1=CC=C2C(=C1)C(=O)N(C2=O)NC(=O)C3=CC=CC=C3C(=O)O<SEP><PAD><PAD><PAD><PAD><PAD><PAD><PAD><PAD><PAD><PAD><PAD><PAD><PAD><PAD><PAD><PAD><PAD><PAD><PAD><PAD><PAD><PAD><PAD><PAD><PAD><PAD><PAD><PAD><PAD><PAD><PAD><PAD><PAD><PAD><PAD><PAD><PAD><PAD><PAD><PAD><PAD><PAD><PAD><PAD><PAD><PAD><PAD><PAD><PAD>
<CLS>CC1=NN=C(S1)NC(=O)CCNC(=O)C2=CC3=CC=CC=C3C=C2<SEP>CCCCCCCCCCCCCCCCCCCCCCCCCCCCCCCCCCCCCCCCCCCCCCCCCCCCC	<CLS>CC1=NN=C(S1)NC(=O)CCNC(=O)C2=CC3=CC=CC=C3C=C2<SEP><PAD><PAD><PAD><PAD><PAD><PAD><PAD><PAD><PAD><PAD><PAD><PAD><PAD><PAD><PAD><PAD><PAD><PAD><PAD><PAD><PAD><PAD><PAD><PAD><PAD><PAD><PAD><PAD><PAD><PAD><PAD><PAD><PAD><PAD><PAD><PAD><PAD><PAD><PAD><PAD><PAD><PAD><PAD><PAD><PAD><PAD><PAD><PAD><PAD><PAD><PAD><PAD><PAD>
<CLS>CSC1=CC=CC=C1NC(=O)C2=CC3=C(CCCC3)N=C2<SEP>CCCCCCCCCCCCCCCCCCCCCCCCCCCCCCCCCCCCCCCCCCCCCCCCCCCCCCCCCCCC	<CLS>CSC1=CC=CC=C1NC(=O)C2=CC3=C(CCCC3)C=C2<SEP><PAD><PAD><PAD><PAD><PAD><PAD><PAD><PAD><PAD><PAD><PAD><PAD><PAD><PAD><PAD><PAD><PAD><PAD><PAD><PAD><PAD><PAD><PAD><PAD><PAD><PAD><PAD><PAD><PAD><PAD><PAD><PAD><PAD><PAD><PAD><PAD><PAD><PAD><PAD><PAD><PAD><PAD><PAD><PAD><PAD><PAD><PAD><PAD><PAD><PAD><PAD><PAD><PAD><PAD><PAD><PAD><PAD><PAD><PAD><PAD>
<CLS>CC1CCCC2=C3CC=C4CC(CCC4(C3CC2)C)OC(=O)C(F)(F)F<SEP>CCCCCCCCCCCCCCCCCCCCCCCCCCCCCCCCCCCCCCCCCCCCCCCCCCCC	<CLS>CC12CCCC1C3CC=C4CC(CCC4(C3CC2)C)OC(=O)C(F)(F)F<SEP><PAD><PAD><PAD><PAD><PAD><PAD><PAD><PAD><PAD><PAD><PAD><PAD><PAD><PAD><PAD><PAD><PAD><PAD><PAD><PAD><PAD><PAD><PAD><PAD><PAD><PAD><PAD><PAD><PAD><PAD><PAD><PAD><PAD><PAD><PAD><PAD><PAD><PAD><PAD><PAD><PAD><PAD><PAD><PAD><PAD><PAD><PAD><PAD><PAD><PAD><PAD><PAD>
<CLS>CCCCCCCCCCCCCCCC)C(=O)S<SEP>CCCCCCCCCCCCCCCCCCCCCCCCCCCCCCCCCCCCCCCCCCCCCCCCCCCCCCCCCCCCCCCCCCCCCCCCCCC	<CLS>CCCCCCCCCCCCC(CC)C(=O)S<SEP><PAD><PAD><PAD><PAD><PAD><PAD><PAD><PAD><PAD><PAD><PAD><PAD><PAD><PAD><PAD><PAD><PAD><PAD><PAD><PAD><PAD><PAD><PAD><PAD><PAD><PAD><PAD><PAD><PAD><PAD><PAD><PAD><PAD><PAD><PAD><PAD><PAD><PAD><PAD><PAD><PAD><PAD><PAD><PAD><PAD><PAD><PAD><PAD><PAD><PAD><PAD><PAD><PAD><PAD><PAD><PAD><PAD><PAD><PAD><PAD><PAD><PAD><PAD><PAD><PAD><PAD><PAD><PAD><PAD><PAD><PAD><PAD><PAD><PAD><PAD>
<CLS>CCC1=CC=C(C=C1)C2=CSC(=N2)NC(=O)C(C)OC(=O)CCC(=O)O<SEP>CCCCCCCCCCCCCCCCCCCCCCCCCCCCCCCCCCCCCCCCCCCCCCCC	<CLS>CCC1=CC=C(C=C1)C2=CSC(=N2)NC(=O)C(C)OC(=O)CCC(=O)C<SEP><PAD><PAD><PAD><PAD><PAD><PAD><PAD><PAD><PAD><PAD><PAD><PAD><PAD><PAD><PAD><PAD><PAD><PAD><PAD><PAD><PAD><PAD><PAD><PAD><PAD><PAD><PAD><PAD><PAD><PAD><PAD><PAD><PAD><PAD><PAD><PAD><PAD><PAD><PAD><PAD><PAD><PAD><PAD><PAD><PAD><PAD><PAD><PAD>
<CLS>C1CCN(CC1)C2=C(C=C(C=C2)CO)[N+](=O)[O-]<SEP>CCCCCCCCCCCCCCCCCCCCCCCCCCCCCCCCCCCCCCCCCCCCCCCCCCCCCCCCCCC	<CLS>C1CCN(CC1)C2=C(C=C(C=C2)CO)[N+](=O)[O-]<SEP><PAD><PAD><PAD><PAD><PAD><PAD><PAD><PAD><PAD><PAD><PAD><PAD><PAD><PAD><PAD><PAD><PAD><PAD><PAD><PAD><PAD><PAD><PAD><PAD><PAD><PAD><PAD><PAD><PAD><PAD><PAD><PAD><PAD><PAD><PAD><PAD><PAD><PAD><PAD><PAD><PAD><PAD><PAD><PAD><PAD><PAD><PAD><PAD><PAD><PAD><PAD><PAD><PAD><PAD><PAD><PAD><PAD><PAD><PAD>
<CLS>C1CCC2C(C1)C(=O)N(C2=O)C3=CC=C(C=C3)C(=O)OC4=CC=C(C=C4)Cl<SEP>CCCCCCCCCCCCCCCCCCCCCCCCCCCCCCCCCCCCCCCCC	<CLS>C1CCC2C(C1)C(=O)N(C2=O)C3=CC=CC(=C3)C(=O)OC4=CC=C(C=C4)Cl<SEP><PAD><PAD><PAD><PAD><PAD><PAD><PAD><PAD><PAD><PAD><PAD><PAD><PAD><PAD><PAD><PAD><PAD><PAD><PAD><PAD><PAD><PAD><PAD><PAD><PAD><PAD><PAD><PAD><PAD><PAD><PAD><PAD><PAD><PAD><PAD><PAD><PAD><PAD><PAD><PAD><PAD>
<CLS>CC(C(=O)SCC(=O)[O-])NC(=O)C1=CC=CC=C1<SEP>CCCCCCCCCCCCCCCCCCCCCCCCCCCCCCCCCCCCCCCCCCCCCCCCCCCCCCCCCCCCC	<CLS>CC(C(=O)SCC(=O)[O-])NC(=O)C1=CC=CC=C1<SEP><PAD><PAD><PAD><PAD><PAD><PAD><PAD><PAD><PAD><PAD><PAD><PAD><PAD><PAD><PAD><PAD><PAD><PAD><PAD><PAD><PAD><PAD><PAD><PAD><PAD><PAD><PAD><PAD><PAD><PAD><PAD><PAD><PAD><PAD><PAD><PAD><PAD><PAD><PAD><PAD><PAD><PAD><PAD><PAD><PAD><PAD><PAD><PAD><PAD><PAD><PAD><PAD><PAD><PAD><PAD><PAD><PAD><PAD><PAD><PAD><PAD>
<CLS>CC(=O)OCC(C1C(OC(O1)(C)C)C(CO)O)NC(=O)OC(C)(C)C<SEP>CCCCCCCCCCCCCCCCCCCCCCCCCCCCCCCCCCCCCCCCCCCCCCCCCCC	<CLS>CC(=O)OCC(C1C(OC(O1)(C)C)C(CO)O)NC(=O)OC(C)(C)C<SEP><PAD><PAD><PAD><PAD><PAD><PAD><PAD><PAD><PAD><PAD><PAD><PAD><PAD><PAD><PAD><PAD><PAD><PAD><PAD><PAD><PAD><PAD><PAD><PAD><PAD><PAD><PAD><PAD><PAD><PAD><PAD><PAD><PAD><PAD><PAD><PAD><PAD><PAD><PAD><PAD><PAD><PAD><PAD><PAD><PAD><PAD><PAD><PAD><PAD><PAD><PAD>
<CLS>CC1=CC2=C(C=C1)NC3=C2CCCC3NCC(CC4=CC=CC=C4)O<SEP>CCCCCCCCCCCCCCCCCCCCCCCCCCCCCCCCCCCCCCCCCCCCCCCCCCCCCC	<CLS>CC1=CC2=C(C=C1)NC3=C2CCCC3NCC(CC4=CC=CC=C4)O<SEP><PAD><PAD><PAD><PAD><PAD><PAD><PAD><PAD><PAD><PAD><PAD><PAD><PAD><PAD><PAD><PAD><PAD><PAD><PAD><PAD><PAD><PAD><PAD><PAD><PAD><PAD><PAD><PAD><PAD><PAD><PAD><PAD><PAD><PAD><PAD><PAD><PAD><PAD><PAD><PAD><PAD><PAD><PAD><PAD><PAD><PAD><PAD><PAD><PAD><PAD><PAD><PAD><PAD><PAD>
<CLS>CCOC1=C(C=C2C(=C1)CC(O2)C)NC(=O)C3=CC(=CC=C3)NC(=O)C<SEP>CCCCCCCCCCCCCCCCCCCCCCCCCCCCCCCCCCCCCCCCCCCCCC	<CLS>CCOC1=C(C=C2C(=C1)CC(O2)C)NC(=O)C3=NC(=CC=C3)NC(=O)C<SEP><PAD><PAD><PAD><PAD><PAD><PAD><PAD><PAD><PAD><PAD><PAD><PAD><PAD><PAD><PAD><PAD><PAD><PAD><PAD><PAD><PAD><PAD><PAD><PAD><PAD><PAD><PAD><PAD><PAD><PAD><PAD><PAD><PAD><PAD><PAD><PAD><PAD><PAD><PAD><PAD><PAD><PAD><PAD><PAD><PAD><PAD>
<CLS>CCC1CC(C2=CC=CC=C2O1)C(=O)N3CCC(CC3)C(=O)NCCN4CCN(CC4)C<SEP>CCCCCCCCCCCCCCCCCCCCCCCCCCCCCCCCCCCCCCCCCCC	<CLS>CCC1CN(C2=CC=CC=C2O1)C(=O)N3CCC(CC3)C(=O)NCCN4CCN(CC4)C<SEP><PAD><PAD><PAD><PAD><PAD><PAD><PAD><PAD><PAD><PAD><PAD><PAD><PAD><PAD><PAD><PAD><PAD><PAD><PAD><PAD><PAD><PAD><PAD><PAD><PAD><PAD><PAD><PAD><PAD><PAD><PAD><PAD><PAD><PAD><PAD><PAD><PAD><PAD><PAD><PAD><PAD><PAD><PAD>
<CLS>CC(C(=O)NC1=CC2=C(CCC2)C=C1)NC(=O)C3=CC=CS3<SEP>CCCCCCCCCCCCCCCCCCCCCCCCCCCCCCCCCCCCCCCCCCCCCCCCCCCCCCC	<CLS>CC(C(=O)NC1=CC2=C(CCC2)C=C1)OC(=O)C3=CC=CN3<SEP><PAD><PAD><PAD><PAD><PAD><PAD><PAD><PAD><PAD><PAD><PAD><PAD><PAD><PAD><PAD><PAD><PAD><PAD><PAD><PAD><PAD><PAD><PAD><PAD><PAD><PAD><PAD><PAD><PAD><PAD><PAD><PAD><PAD><PAD><PAD><PAD><PAD><PAD><PAD><PAD><PAD><PAD><PAD><PAD><PAD><PAD><PAD><PAD><PAD><PAD><PAD><PAD><PAD><PAD><PAD>
<CLS>B(C1=C(C(=C(C(=C1F)F)F)F)F)(C2=C(C(=C(C(=C2F)F)F)F)F)Cl<SEP>CCCCCCCCCCCCCCCCCCCCCCCCCCCCCCCCCCCCCCCCCCC	<CLS>B(C1=C(C(=C(C(=C1F)F)F)F)F)(C2=C(C(=C(C(=C2F)F)F)F)F)Cl<SEP><PAD><PAD><PAD><PAD><PAD><PAD><PAD><PAD><PAD><PAD><PAD><PAD><PAD><PAD><PAD><PAD><PAD><PAD><PAD><PAD><PAD><PAD><PAD><PAD><PAD><PAD><PAD><PAD><PAD><PAD><PAD><PAD><PAD><PAD><PAD><PAD><PAD><PAD><PAD><PAD><PAD><PAD><PAD>
<CLS>CC(=O)C1=CC(=CC=C1)NC(=O)CNC(=O)C2=CC(=C(C=C2)Cl)N3CCCC3=O<SEP>CCCCCCCCCCCCCCCCCCCCCCCCCCCCCCCCCCCCCCCC	<CLS>CC(=O)C1=CC(=CC=C1)NC(=O)COC(=O)C2=CC(=C(C=C2)Cl)N3CCCC3=O<SEP><PAD><PAD><PAD><PAD><PAD><PAD><PAD><PAD><PAD><PAD><PAD><PAD><PAD><PAD><PAD><PAD><PAD><PAD><PAD><PAD><PAD><PAD><PAD><PAD><PAD><PAD><PAD><PAD><PAD><PAD><PAD><PAD><PAD><PAD><PAD><PAD><PAD><PAD><PAD><PAD>
<CLS>CC1=CC=C(C=C1)C(CC2=C(C=CC(=C2)Br)OCC3=CC=CC=C3)Cl<SEP>CCCCCCCCCCCCCCCCCCCCCCCCCCCCCCCCCCCCCCCCCCCCCCCC	<CLS>CC1=CC=C(C=C1)CNCC2=C(C=CC(=C2)Br)OCC3=CC=CC=C3.Cl<SEP><PAD><PAD><PAD><PAD><PAD><PAD><PAD><PAD><PAD><PAD><PAD><PAD><PAD><PAD><PAD><PAD><PAD><PAD><PAD><PAD><PAD><PAD><PAD><PAD><PAD><PAD><PAD><PAD><PAD><PAD><PAD><PAD><PAD><PAD><PAD><PAD><PAD><PAD><PAD><PAD><PAD><PAD><PAD><PAD><PAD><PAD><PAD><PAD>
<CLS>COC1=C(C=C(C(=C1)F)N)Br<SEP>CCCCCCCCCCCCCCCCCCCCCCCCCCCCCCCCCCCCCCCCCCCCCCCCCCCCCCCCCCCCCCCCCCCCCCCCCCC	<CLS>COC1=C(C=C(C(=C1)N)N)Br<SEP><PAD><PAD><PAD><PAD><PAD><PAD><PAD><PAD><PAD><PAD><PAD><PAD><PAD><PAD><PAD><PAD><PAD><PAD><PAD><PAD><PAD><PAD><PAD><PAD><PAD><PAD><PAD><PAD><PAD><PAD><PAD><PAD><PAD><PAD><PAD><PAD><PAD><PAD><PAD><PAD><PAD><PAD><PAD><PAD><PAD><PAD><PAD><PAD><PAD><PAD><PAD><PAD><PAD><PAD><PAD><PAD><PAD><PAD><PAD><PAD><PAD><PAD><PAD><PAD><PAD><PAD><PAD><PAD><PAD><PAD><PAD><PAD><PAD><PAD><PAD>
<CLS>CCCCC1=CC=C(C=C1)N2C(=NN=N2)SCC(=O)NCC3=CC=C(C=C3)C(=O)OC<SEP>CCCCCCCCCCCCCCCCCCCCCCCCCCCCCCCCCCCCCCCCC	<CLS>CCCCC1=CC=C(C=C1)N2C(=NN=N2)SCC(=O)NCC3=CC=C(C=C3)C(=O)OC<SEP><PAD><PAD><PAD><PAD><PAD><PAD><PAD><PAD><PAD><PAD><PAD><PAD><PAD><PAD><PAD><PAD><PAD><PAD><PAD><PAD><PAD><PAD><PAD><PAD><PAD><PAD><PAD><PAD><PAD><PAD><PAD><PAD><PAD><PAD><PAD><PAD><PAD><PAD><PAD><PAD><PAD>
<CLS>CCN1CCN(CC1)CC2=C(C(NC(=O)N2)C3=CC=CC=C3Cl)C(=O)O)C<SEP>CCCCCCCCCCCCCCCCCCCCCCCCCCCCCCCCCCCCCCCCCCCCCCC	<CLS>CCN1CCN(CC1)CC2=C(C(NC(=O)N2)C3=CC=CC=C3Cl)C(=O)OCC<SEP><PAD><PAD><PAD><PAD><PAD><PAD><PAD><PAD><PAD><PAD><PAD><PAD><PAD><PAD><PAD><PAD><PAD><PAD><PAD><PAD><PAD><PAD><PAD><PAD><PAD><PAD><PAD><PAD><PAD><PAD><PAD><PAD><PAD><PAD><PAD><PAD><PAD><PAD><PAD><PAD><PAD><PAD><PAD><PAD><PAD><PAD><PAD>
<CLS>C1=CC=C(C(=C1)C=NNC(=O)C2=NN(C=C2)CC3=CC=C(C=C3)Br)O<SEP>CCCCCCCCCCCCCCCCCCCCCCCCCCCCCCCCCCCCCCCCCCCCCC	<CLS>C1=CC=C(C(=C1)C=NNC(=O)C2=NN(C=C2)CC3=CC=C(C=C3)Br)F<SEP><PAD><PAD><PAD><PAD><PAD><PAD><PAD><PAD><PAD><PAD><PAD><PAD><PAD><PAD><PAD><PAD><PAD><PAD><PAD><PAD><PAD><PAD><PAD><PAD><PAD><PAD><PAD><PAD><PAD><PAD><PAD><PAD><PAD><PAD><PAD><PAD><PAD><PAD><PAD><PAD><PAD><PAD><PAD><PAD><PAD><PAD>
<CLS>CCC(=NOCCOC1=CC=CC(=C1C)CC(=O)O)C2=CC=C(C=C2)N3C=CC=N3<SEP>CCCCCCCCCCCCCCCCCCCCCCCCCCCCCCCCCCCCCCCCCCCC	<CLS>CCC(=NOCCOC1=CC=CC(=C1C)CC(=O)O)C2=CC=C(C=C2)N3C=CC=N3<SEP><PAD><PAD><PAD><PAD><PAD><PAD><PAD><PAD><PAD><PAD><PAD><PAD><PAD><PAD><PAD><PAD><PAD><PAD><PAD><PAD><PAD><PAD><PAD><PAD><PAD><PAD><PAD><PAD><PAD><PAD><PAD><PAD><PAD><PAD><PAD><PAD><PAD><PAD><PAD><PAD><PAD><PAD><PAD><PAD>
