output	target
<CLS>CC(=O)C1=CC=C(C=C1)CCCN(CCOC2=CC=C(C=C2)C(=O)O)CCCC3=CC=C(C=C3)C(=O)O<SEP>CCCCCCCCCCCCCCCCCCCCCCCCCCCCC	<CLS>CC(=O)C1=CC=C(C=C1)OCCN(CCOC2=CC=C(C=C2)C(=O)C)CCOC3=CC=C(C=C3)C(=O)C<SEP><PAD><PAD><PAD><PAD><PAD><PAD><PAD><PAD><PAD><PAD><PAD><PAD><PAD><PAD><PAD><PAD><PAD><PAD><PAD><PAD><PAD><PAD><PAD><PAD><PAD><PAD><PAD><PAD><PAD>
<CLS>C1C(COC1P(=O)(F)F)N2C=CC(=CC2=O)N<SEP>CCCCCCCCCCCCCCCCCCCCCCCCCCCCCCCCCCCCCCCCCCCCCCCCCCCCCCCCCCCCCCCCC	<CLS>C1C(COC1P(=O)(O)O)N2C=CC(=NC2=O)N<SEP><PAD><PAD><PAD><PAD><PAD><PAD><PAD><PAD><PAD><PAD><PAD><PAD><PAD><PAD><PAD><PAD><PAD><PAD><PAD><PAD><PAD><PAD><PAD><PAD><PAD><PAD><PAD><PAD><PAD><PAD><PAD><PAD><PAD><PAD><PAD><PAD><PAD><PAD><PAD><PAD><PAD><PAD><PAD><PAD><PAD><PAD><PAD><PAD><PAD><PAD><PAD><PAD><PAD><PAD><PAD><PAD><PAD><PAD><PAD><PAD><PAD><PAD><PAD><PAD><PAD>
<CLS>CC1(CC2=C(C=C((=N2)C#CC3=NC(=C(O3)C4=CN=CC=C4)F)C(=O)C1)C<SEP>CCCCCCCCCCCCCCCCCCCCCCCCCCCCCCCCCCCCCCCCC	<CLS>CC1(CC2=C(C=CC(=N2)C#CC3=NC(=C(O3)C4=CN=CC=C4)F)C(=O)C1)C<SEP><PAD><PAD><PAD><PAD><PAD><PAD><PAD><PAD><PAD><PAD><PAD><PAD><PAD><PAD><PAD><PAD><PAD><PAD><PAD><PAD><PAD><PAD><PAD><PAD><PAD><PAD><PAD><PAD><PAD><PAD><PAD><PAD><PAD><PAD><PAD><PAD><PAD><PAD><PAD><PAD><PAD>
<CLS>C1=CC=C(C=C1)N[P+](C2=CC=CC=C2)(C3=CC=CC=C3)C4=CC=CC=C4)C5=C(BC)(Br)(Br)Br<SEP>CCCCCCCCCCCCCCCCCCCCCCCC	<CLS>C1=CC=C(C=C1)N[P+](C2=CC=CC=C2)(C3=CC=CC=C3)C4=CC=CC=C4.[Fe](Br)(Br)(Br)Br<SEP><PAD><PAD><PAD><PAD><PAD><PAD><PAD><PAD><PAD><PAD><PAD><PAD><PAD><PAD><PAD><PAD><PAD><PAD><PAD><PAD><PAD><PAD><PAD><PAD>
<CLS>COC(=O)C(CC1=CC(=CC=C1)Cl)[N+]2=CC=CC=C2.[Br-]<SEP>CCCCCCCCCCCCCCCCCCCCCCCCCCCCCCCCCCCCCCCCCCCCCCCCCCCC	<CLS>COC(=O)C(CC1=CC(=CC=C1)Cl)[N+]2=CC=CC=C2.[Br-]<SEP><PAD><PAD><PAD><PAD><PAD><PAD><PAD><PAD><PAD><PAD><PAD><PAD><PAD><PAD><PAD><PAD><PAD><PAD><PAD><PAD><PAD><PAD><PAD><PAD><PAD><PAD><PAD><PAD><PAD><PAD><PAD><PAD><PAD><PAD><PAD><PAD><PAD><PAD><PAD><PAD><PAD><PAD><PAD><PAD><PAD><PAD><PAD><PAD><PAD><PAD><PAD><PAD>
<CLS>C1=C(NC(=C1Br)Br)C(=O)N2CCNCCCCN<SEP>CCCCCCCCCCCCCCCCCCCCCCCCCCCCCCCCCCCCCCCCCCCCCCCCCCCCCCCCCCCCCCCCCC	<CLS>C1=C(NC(=C1Br)Br)C(=O)NCCCNCCCCN<SEP><PAD><PAD><PAD><PAD><PAD><PAD><PAD><PAD><PAD><PAD><PAD><PAD><PAD><PAD><PAD><PAD><PAD><PAD><PAD><PAD><PAD><PAD><PAD><PAD><PAD><PAD><PAD><PAD><PAD><PAD><PAD><PAD><PAD><PAD><PAD><PAD><PAD><PAD><PAD><PAD><PAD><PAD><PAD><PAD><PAD><PAD><PAD><PAD><PAD><PAD><PAD><PAD><PAD><PAD><PAD><PAD><PAD><PAD><PAD><PAD><PAD><PAD><PAD><PAD><PAD><PAD>
<CLS>COCCN1C(=O)C(=CC2=CC=C(C=C2)OCC3=CC=C(C=C3)C(=O)[O-])SC1=NC4=CC=CC=C4<SEP>CCCCCCCCCCCCCCCCCCCCCCCCCCCCC	<CLS>COCCN1C(=O)C(=CC2=CC=C(C=C2)OCC3=CC=C(C=C3)C(=O)[O-])SC1=NC4=CC=CC=C4<SEP><PAD><PAD><PAD><PAD><PAD><PAD><PAD><PAD><PAD><PAD><PAD><PAD><PAD><PAD><PAD><PAD><PAD><PAD><PAD><PAD><PAD><PAD><PAD><PAD><PAD><PAD><PAD><PAD><PAD>
<CLS>CC(C1=CC=CC=C1)NC(=O)C2=CC(=CC=C2)S(=O)(=O)N3CCC(CC3)C(=O)C<SEP>CCCCCCCCCCCCCCCCCCCCCCCCCCCCCCCCCCCCCCC	<CLS>CC(C1=CC=CC=C1)NC(=O)C2=CC(=CC=C2)S(=O)(=O)N3CCN(CC3)C(=O)C<SEP><PAD><PAD><PAD><PAD><PAD><PAD><PAD><PAD><PAD><PAD><PAD><PAD><PAD><PAD><PAD><PAD><PAD><PAD><PAD><PAD><PAD><PAD><PAD><PAD><PAD><PAD><PAD><PAD><PAD><PAD><PAD><PAD><PAD><PAD><PAD><PAD><PAD><PAD><PAD>
<CLS>CC1(CC2=C(C=C3C(=N2)C4=CC=CC=C4C3=O)C5=CC=CS5)C(=O)C1)C<SEP>CCCCCCCCCCCCCCCCCCCCCCCCCCCCCCCCCCCCCCCCCCC	<CLS>CC1(CC2=C(C(C3C(=N2)C4=CC=CC=C4C3=O)C5=CC=CS5)C(=O)C1)C<SEP><PAD><PAD><PAD><PAD><PAD><PAD><PAD><PAD><PAD><PAD><PAD><PAD><PAD><PAD><PAD><PAD><PAD><PAD><PAD><PAD><PAD><PAD><PAD><PAD><PAD><PAD><PAD><PAD><PAD><PAD><PAD><PAD><PAD><PAD><PAD><PAD><PAD><PAD><PAD><PAD><PAD><PAD><PAD>
<CLS>CC(C)(C1=CN(C2=CC=CC=C21)C)C(=O)OC<SEP>CCCCCCCCCCCCCCCCCCCCCCCCCCCCCCCCCCCCCCCCCCCCCCCCCCCCCCCCCCCCCCCC	<CLS>CC(C)(C1=CN(C2=CC=CC=C21)C)C(=O)OC<SEP><PAD><PAD><PAD><PAD><PAD><PAD><PAD><PAD><PAD><PAD><PAD><PAD><PAD><PAD><PAD><PAD><PAD><PAD><PAD><PAD><PAD><PAD><PAD><PAD><PAD><PAD><PAD><PAD><PAD><PAD><PAD><PAD><PAD><PAD><PAD><PAD><PAD><PAD><PAD><PAD><PAD><PAD><PAD><PAD><PAD><PAD><PAD><PAD><PAD><PAD><PAD><PAD><PAD><PAD><PAD><PAD><PAD><PAD><PAD><PAD><PAD><PAD><PAD><PAD>
<CLS>C1=CC=C(C(=C1)COC2=CC=C(C=C2)CNCCC3=C(C=C(C=C3)Cl)Cl)F<SEP>CCCCCCCCCCCCCCCCCCCCCCCCCCCCCCCCCCCCCCCCCCCC	<CLS>C1=CC=C(C(=C1)COC2=CC=CC(=C2)CNCCC3=C(C=C(C=C3)Cl)Cl)F<SEP><PAD><PAD><PAD><PAD><PAD><PAD><PAD><PAD><PAD><PAD><PAD><PAD><PAD><PAD><PAD><PAD><PAD><PAD><PAD><PAD><PAD><PAD><PAD><PAD><PAD><PAD><PAD><PAD><PAD><PAD><PAD><PAD><PAD><PAD><PAD><PAD><PAD><PAD><PAD><PAD><PAD><PAD><PAD><PAD>
<CLS>CC1=CC=C(C=C1)C(C2=NN=C(N2C3=CC=CC(=C3)C)C4CCCCC4<SEP>CCCCCCCCCCCCCCCCCCCCCCCCCCCCCCCCCCCCCCCCCCCCCCCCC	<CLS>CC1=CC=C(C=C1)CSC2=NN=C(N2C3=CC=CC(=C3)C)C4CCCCC4<SEP><PAD><PAD><PAD><PAD><PAD><PAD><PAD><PAD><PAD><PAD><PAD><PAD><PAD><PAD><PAD><PAD><PAD><PAD><PAD><PAD><PAD><PAD><PAD><PAD><PAD><PAD><PAD><PAD><PAD><PAD><PAD><PAD><PAD><PAD><PAD><PAD><PAD><PAD><PAD><PAD><PAD><PAD><PAD><PAD><PAD><PAD><PAD><PAD><PAD>
<CLS>CC(C(=O)NC1=CC=CC(=C1)C#N)N(C)CC2=CC=C(C=C2)Cl<SEP>CCCCCCCCCCCCCCCCCCCCCCCCCCCCCCCCCCCCCCCCCCCCCCCCCCCC	<CLS>CC(C(=O)NC1=CC=CC(=C1)C#N)N(C)CC2=CC=C(C=C2)Cl<SEP><PAD><PAD><PAD><PAD><PAD><PAD><PAD><PAD><PAD><PAD><PAD><PAD><PAD><PAD><PAD><PAD><PAD><PAD><PAD><PAD><PAD><PAD><PAD><PAD><PAD><PAD><PAD><PAD><PAD><PAD><PAD><PAD><PAD><PAD><PAD><PAD><PAD><PAD><PAD><PAD><PAD><PAD><PAD><PAD><PAD><PAD><PAD><PAD><PAD><PAD><PAD><PAD>
<CLS>COC1=CC=CC2=C1OC(=C2)CN3CCC(CC3)(C4=CC=C(C=C4)Cl)O<SEP>CCCCCCCCCCCCCCCCCCCCCCCCCCCCCCCCCCCCCCCCCCCCCCCC	<CLS>COC1=CC=CC2=C1OC(CC2)CN3CCC(CC3)(C4=CC=C(C=C4)Cl)O<SEP><PAD><PAD><PAD><PAD><PAD><PAD><PAD><PAD><PAD><PAD><PAD><PAD><PAD><PAD><PAD><PAD><PAD><PAD><PAD><PAD><PAD><PAD><PAD><PAD><PAD><PAD><PAD><PAD><PAD><PAD><PAD><PAD><PAD><PAD><PAD><PAD><PAD><PAD><PAD><PAD><PAD><PAD><PAD><PAD><PAD><PAD><PAD><PAD>
<CLS>CC(C1=CC2=CC=CC=C2C=C1)NC(=O)C3=CC=C(C=C3)CS(=O)(=O)C<SEP>CCCCCCCCCCCCCCCCCCCCCCCCCCCCCCCCCCCCCCCCCCCCC	<CLS>CC(C1=CC2=CC=CC=C2C=C1)NC(=O)C3=CC=C(C=C3)CS(=O)(=O)C<SEP><PAD><PAD><PAD><PAD><PAD><PAD><PAD><PAD><PAD><PAD><PAD><PAD><PAD><PAD><PAD><PAD><PAD><PAD><PAD><PAD><PAD><PAD><PAD><PAD><PAD><PAD><PAD><PAD><PAD><PAD><PAD><PAD><PAD><PAD><PAD><PAD><PAD><PAD><PAD><PAD><PAD><PAD><PAD><PAD><PAD>
<CLS>CCOC(=O)C1CC2C(C(C2)C)C3=CC(=C(C=C3C1=O)F)N4CCN(CC4)C(C)C<SEP>CCCCCCCCCCCCCCCCCCCCCCCCCCCCCCCCCCCCCCCCC	<CLS>CCOC(=O)C1=C2N(C(S2)C)C3=CC(=C(C=C3C1=O)F)N4CCN(CC4)C(C)C<SEP><PAD><PAD><PAD><PAD><PAD><PAD><PAD><PAD><PAD><PAD><PAD><PAD><PAD><PAD><PAD><PAD><PAD><PAD><PAD><PAD><PAD><PAD><PAD><PAD><PAD><PAD><PAD><PAD><PAD><PAD><PAD><PAD><PAD><PAD><PAD><PAD><PAD><PAD><PAD><PAD><PAD>
<CLS>CC1=C(C(C(=C(N1)C)C(=O)NC2=CC=CC=C2)C3=CC=CC=C3)C4=CC=CC=C4SC)C(=O)OC<SEP>CCCCCCCCCCCCCCCCCCCCCCCCCCCCC	<CLS>CC1=C(C(C(=C(N1)C)C(=O)OC(CN2CCCCC2)C3=CC=CC=C3)C4=CC=CC=C4SC)C(=O)OC<SEP><PAD><PAD><PAD><PAD><PAD><PAD><PAD><PAD><PAD><PAD><PAD><PAD><PAD><PAD><PAD><PAD><PAD><PAD><PAD><PAD><PAD><PAD><PAD><PAD><PAD><PAD><PAD><PAD><PAD>
<CLS>CCCCCCCNC(=O)C1=C(N(C2=NC3=CC=CC=C3N=C12)C4=CCC=C(C=C4)C)C)N<SEP>CCCCCCCCCCCCCCCCCCCCCCCCCCCCCCCCCCCCCC	<CLS>CCCCCCCNC(=O)C1=C(N(C2=NC3=CC=CC=C3N=C12)C4=CC(=C(C=C4)C)C)N<SEP><PAD><PAD><PAD><PAD><PAD><PAD><PAD><PAD><PAD><PAD><PAD><PAD><PAD><PAD><PAD><PAD><PAD><PAD><PAD><PAD><PAD><PAD><PAD><PAD><PAD><PAD><PAD><PAD><PAD><PAD><PAD><PAD><PAD><PAD><PAD><PAD><PAD><PAD>
<CLS>COC1=C(C=C(C=C1)Br)C=CC2=CC=C(C=C2)C3=CC=C(C=C3)N=CC4=C(C=CC(=C4)Br)OC<SEP>CCCCCCCCCCCCCCCCCCCCCCCCCCCC	<CLS>COC1=C(C=C(C=C1)Br)C=NC2=CC=C(C=C2)C3=CC=C(C=C3)N=CC4=C(C=CC(=C4)Br)OC<SEP><PAD><PAD><PAD><PAD><PAD><PAD><PAD><PAD><PAD><PAD><PAD><PAD><PAD><PAD><PAD><PAD><PAD><PAD><PAD><PAD><PAD><PAD><PAD><PAD><PAD><PAD><PAD><PAD>
<CLS>CCC(C(=O)NC1=NOC(=N1)C)N2CCN(CC2)C3=CC=C(C=C3)OC<SEP>CCCCCCCCCCCCCCCCCCCCCCCCCCCCCCCCCCCCCCCCCCCCCCCCCC	<CLS>CCC(C(=O)NC1=NOC(=C1)C)N2CCN(CC2)C3=CC=C(C=C3)OC<SEP><PAD><PAD><PAD><PAD><PAD><PAD><PAD><PAD><PAD><PAD><PAD><PAD><PAD><PAD><PAD><PAD><PAD><PAD><PAD><PAD><PAD><PAD><PAD><PAD><PAD><PAD><PAD><PAD><PAD><PAD><PAD><PAD><PAD><PAD><PAD><PAD><PAD><PAD><PAD><PAD><PAD><PAD><PAD><PAD><PAD><PAD><PAD><PAD><PAD><PAD>
<CLS>CCC(CC(=O)N(CCCCCC(=O)N(CCC1=CNC2=CC=CC=C21)CC3=CC=C(C=C3)OCC<SEP>CCCCCCCCCCCCCCCCCCCCCCCCCCCCCCCCCCCCC	<CLS>CCCCCC(=O)N(CCC)CC(=O)N(CCC1=CNC2=CC=CC=C21)CC3=CC=C(C=C3)OCC<SEP><PAD><PAD><PAD><PAD><PAD><PAD><PAD><PAD><PAD><PAD><PAD><PAD><PAD><PAD><PAD><PAD><PAD><PAD><PAD><PAD><PAD><PAD><PAD><PAD><PAD><PAD><PAD><PAD><PAD><PAD><PAD><PAD><PAD><PAD><PAD><PAD><PAD>
<CLS>COC1=CC(=CC(=C1OC)OC)C2C3=C(C=C(C=C3)OC(=O)C=CC4=CC=C(C=C4)Cl)OC(=C2)#CCN<SEP>CCCCCCCCCCCCCCCCCCCCCCCCC	<CLS>COC1=CC(=CC(=C1OC)OC)C2C3=C(C=C(C=C3)OC(=O)C=CC4=CC=C(C=C4)Cl)OC(=C2C#N)N<SEP><PAD><PAD><PAD><PAD><PAD><PAD><PAD><PAD><PAD><PAD><PAD><PAD><PAD><PAD><PAD><PAD><PAD><PAD><PAD><PAD><PAD><PAD><PAD><PAD><PAD>
<CLS>CC(C)(C)ON=C1CC(C22C3CCC=C(C(N3C4=C(O2)C=CC(=C4)OC5=CC=CC(=C5)[N+](=O)[O-])CCCCC)CCCCOCOCCCC)N(CC6<SEP>	<CLS>CC(C)(C)ON=C1CC(C2(C3C1=CC(C(C3C4=C(O2)C=CC(=C4)OC5=CC=CC(=C5)[N+](=O)[O-])CCCCO)CCCCO)OCC=C)N(CC6<SEP>
<CLS>C=CCCCC(=O)NC1CC(=O)CC2C1CCN(CC2)S(=O)(=O)C3=CC=CC=C3)CCC=C<SEP>CCCCCCCCCCCCCCCCCCCCCCCCCCCCCCCCCCCCCCC	<CLS>C=CCCCC(=O)NC1CC(=O)CC2C1(CN(CC2)S(=O)(=O)C3=CC=CC=C3)CCC=C<SEP><PAD><PAD><PAD><PAD><PAD><PAD><PAD><PAD><PAD><PAD><PAD><PAD><PAD><PAD><PAD><PAD><PAD><PAD><PAD><PAD><PAD><PAD><PAD><PAD><PAD><PAD><PAD><PAD><PAD><PAD><PAD><PAD><PAD><PAD><PAD><PAD><PAD><PAD><PAD>
<CLS>CN1CCC2(CC1)C(C3C(S2)C(C3=O)NC(=O)C(C4=CC=CC=C4)NC(=O)CCC5=CC=CC=C5)CCCO)OCC6=CC=CC=C6<SEP>CCCCCCCCCCCC	<CLS>CN1CCC2(CC1)C(N3C(S2)C(C3=O)NC(=O)C(C4=CC=CC=C4)NC(=O)OCC5=CC=CC=C5)C(=O)OCC6=CC=CC=C6<SEP><PAD><PAD><PAD><PAD><PAD><PAD><PAD><PAD><PAD><PAD><PAD><PAD>
<CLS>CC(C1=CC=C(C=C1)SC)NC2=C(N=CN2C)[N+](=O)[O-]<SEP>CCCCCCCCCCCCCCCCCCCCCCCCCCCCCCCCCCCCCCCCCCCCCCCCCCCCCC	<CLS>CC(C1=CC=C(C=C1)SC)NC2=C(N=CN2C)[N+](=O)[O-]<SEP><PAD><PAD><PAD><PAD><PAD><PAD><PAD><PAD><PAD><PAD><PAD><PAD><PAD><PAD><PAD><PAD><PAD><PAD><PAD><PAD><PAD><PAD><PAD><PAD><PAD><PAD><PAD><PAD><PAD><PAD><PAD><PAD><PAD><PAD><PAD><PAD><PAD><PAD><PAD><PAD><PAD><PAD><PAD><PAD><PAD><PAD><PAD><PAD><PAD><PAD><PAD><PAD><PAD><PAD>
<CLS>C1CCN(CC1)C(=C(C2=CC=C(C=C2)Cl)C3=NC(=NC(=N3)CC4=CC=C(C=C4)Cl)CC5=CC=C(C=55)ClCCC=CC=CC=C6<SEP>CCCCCCCC	<CLS>C1CCN(CC1)C(=C(C2=CC=C(C=C2)Cl)C3=NC(=NC(=N3)CC4=CC=C(C=C4)Cl)CC5=CC=C(C=C5)Cl)C6=CC=CC=C6<SEP><PAD><PAD><PAD><PAD><PAD><PAD><PAD><PAD>
<CLS>CC1=CC=C(C=C1)CN(C)C(=O)CN2CCN(CC2)C3=CC=CC=C3O<SEP>CCCCCCCCCCCCCCCCCCCCCCCCCCCCCCCCCCCCCCCCCCCCCCCCCCC	<CLS>CC1=CC=C(C=C1)CN(C)C(=O)CN2CCN(CC2)C3=CC=CC=C3O<SEP><PAD><PAD><PAD><PAD><PAD><PAD><PAD><PAD><PAD><PAD><PAD><PAD><PAD><PAD><PAD><PAD><PAD><PAD><PAD><PAD><PAD><PAD><PAD><PAD><PAD><PAD><PAD><PAD><PAD><PAD><PAD><PAD><PAD><PAD><PAD><PAD><PAD><PAD><PAD><PAD><PAD><PAD><PAD><PAD><PAD><PAD><PAD><PAD><PAD><PAD><PAD>
<CLS>CC1=C(C=CC(=C1)C)OCC(=O)NN=CC2=CC=C(O2)C3=CC=CC=C3Cl<SEP>CCCCCCCCCCCCCCCCCCCCCCCCCCCCCCCCCCCCCCCCCCCCCC	<CLS>CC1=C(C(=CC=C1)C)OCC(=O)NN=CC2=CC=C(O2)C3=CC=CC=C3Cl<SEP><PAD><PAD><PAD><PAD><PAD><PAD><PAD><PAD><PAD><PAD><PAD><PAD><PAD><PAD><PAD><PAD><PAD><PAD><PAD><PAD><PAD><PAD><PAD><PAD><PAD><PAD><PAD><PAD><PAD><PAD><PAD><PAD><PAD><PAD><PAD><PAD><PAD><PAD><PAD><PAD><PAD><PAD><PAD><PAD><PAD><PAD>
<CLS>CC1=CC=C(C=C1)C(C(=O)NC2=C(C=CC=C2C)C)N(C)O)C(=O)C(CCSC)NC(=O)OC(C)(C)C<SEP><SEP>CCCCCCCCCCCCCCCCCCCCCCCCCC	<CLS>CC1=CC=C(C=C1)C(C(=O)NC2=C(C=CC=C2C)C)N(CCO)C(=O)C(CCSC)NC(=O)OC(C)(C)C<SEP><PAD><PAD><PAD><PAD><PAD><PAD><PAD><PAD><PAD><PAD><PAD><PAD><PAD><PAD><PAD><PAD><PAD><PAD><PAD><PAD><PAD><PAD><PAD><PAD><PAD><PAD><PAD>
<CLS>C1OC2=C(O1)C=CCC=C2)C(=O)NCC(=O)NN=CC3=CC=C(C=C3)OCC4=CC=CC=C4Cl<SEP>CCCCCCCCCCCCCCCCCCCCCCCCCCCCCCCCCC	<CLS>C1OC2=C(O1)C=C(C=C2)C(=O)NCC(=O)NN=CC3=CC=C(C=C3)OCC4=CC=CC=C4Cl<SEP><PAD><PAD><PAD><PAD><PAD><PAD><PAD><PAD><PAD><PAD><PAD><PAD><PAD><PAD><PAD><PAD><PAD><PAD><PAD><PAD><PAD><PAD><PAD><PAD><PAD><PAD><PAD><PAD><PAD><PAD><PAD><PAD><PAD><PAD>
<CLS>CC1=C(C=C(C=C1)NC2=NC(=C(S2)C3=C4C=C(C=CC4=NC3=O)F)O)Cl<SEP>CCCCCCCCCCCCCCCCCCCCCCCCCCCCCCCCCCCCCCCCCCC	<CLS>CC1=C(C=C(C=C1)NC2=NC(=C(S2)C3=C4C=C(C=CC4=NC3=O)F)O)Cl<SEP><PAD><PAD><PAD><PAD><PAD><PAD><PAD><PAD><PAD><PAD><PAD><PAD><PAD><PAD><PAD><PAD><PAD><PAD><PAD><PAD><PAD><PAD><PAD><PAD><PAD><PAD><PAD><PAD><PAD><PAD><PAD><PAD><PAD><PAD><PAD><PAD><PAD><PAD><PAD><PAD><PAD><PAD><PAD>
<CLS>C1=CC(=CN=C1)CNC(=O)C2=CNC3=C(C2=O)C(=CC(=C3)F)F<SEP>CCCCCCCCCCCCCCCCCCCCCCCCCCCCCCCCCCCCCCCCCCCCCCCCCC	<CLS>C1=CC(=CN=C1)CNC(=O)C2=CNC3=C(C2=O)C(=CC(=C3)F)F<SEP><PAD><PAD><PAD><PAD><PAD><PAD><PAD><PAD><PAD><PAD><PAD><PAD><PAD><PAD><PAD><PAD><PAD><PAD><PAD><PAD><PAD><PAD><PAD><PAD><PAD><PAD><PAD><PAD><PAD><PAD><PAD><PAD><PAD><PAD><PAD><PAD><PAD><PAD><PAD><PAD><PAD><PAD><PAD><PAD><PAD><PAD><PAD><PAD><PAD><PAD>
<CLS>CC1=C(C=C(C=C1)S(=O)(=O)N(C)C)NC(=O)C(C)NC(=O)COC2=CC=C(C=C2)C)SCCCS3<SEP>CCCCCCCCCCCCCCCCCCCCCCCCCCCCC	<CLS>CC1=C(C=C(C=C1)S(=O)(=O)N(C)C)NC(=O)C(C)OC(=O)COC2=CC=C(C=C2)C3SCCCS3<SEP><PAD><PAD><PAD><PAD><PAD><PAD><PAD><PAD><PAD><PAD><PAD><PAD><PAD><PAD><PAD><PAD><PAD><PAD><PAD><PAD><PAD><PAD><PAD><PAD><PAD><PAD><PAD><PAD><PAD>
<CLS>CC1=C(C2C=CC=CC2=N1)C(=C3C(N(C(=O)C3=O)CC[NH+]4CCOCC4)C5=CC=C(C=C5)BC)[C-]<SEP>CCCCCCCCCCCCCCCCCCCCCCCC	<CLS>CC1=C(N2C=CC=CC2=N1)C(=C3C(N(C(=O)C3=O)CC[NH+]4CCOCC4)C5=CC=C(C=C5)Br)[O-]<SEP><PAD><PAD><PAD><PAD><PAD><PAD><PAD><PAD><PAD><PAD><PAD><PAD><PAD><PAD><PAD><PAD><PAD><PAD><PAD><PAD><PAD><PAD><PAD><PAD>
<CLS>CC1CC2=CC=CC=C2N1C(=O)C[NH2+]C(C)C3=CC=CC=C3<SEP>CCCCCCCCCCCCCCCCCCCCCCCCCCCCCCCCCCCCCCCCCCCCCCCCCCCCCC	<CLS>CC1CC2=CC=CC=C2N1C(=O)C[NH2+]C(C)C3=CC=CC=C3<SEP><PAD><PAD><PAD><PAD><PAD><PAD><PAD><PAD><PAD><PAD><PAD><PAD><PAD><PAD><PAD><PAD><PAD><PAD><PAD><PAD><PAD><PAD><PAD><PAD><PAD><PAD><PAD><PAD><PAD><PAD><PAD><PAD><PAD><PAD><PAD><PAD><PAD><PAD><PAD><PAD><PAD><PAD><PAD><PAD><PAD><PAD><PAD><PAD><PAD><PAD><PAD><PAD><PAD><PAD>
<CLS>C1CCC2C(C1)CCCN2C(=O)COC3=CC=CC(=C3)C(=O)NCC4=CC=CC=C4<SEP>CCCCCCCCCCCCCCCCCCCCCCCCCCCCCCCCCCCCCCCCCCCC	<CLS>C1CCC2C(C1)CCCN2C(=O)COC3=CC=CC(=C3)C(=O)NCC4=CC=CC=C4<SEP><PAD><PAD><PAD><PAD><PAD><PAD><PAD><PAD><PAD><PAD><PAD><PAD><PAD><PAD><PAD><PAD><PAD><PAD><PAD><PAD><PAD><PAD><PAD><PAD><PAD><PAD><PAD><PAD><PAD><PAD><PAD><PAD><PAD><PAD><PAD><PAD><PAD><PAD><PAD><PAD><PAD><PAD><PAD><PAD>
<CLS>CC(=O)OCC=CCN(CC=C)C1(C2=CC=CC=C2C3=CC=CC=C31)C4=CC=CC=C4<SEP>CCCCCCCCCCCCCCCCCCCCCCCCCCCCCCCCCCCCCCCCC	<CLS>CC(=O)OCC=CCN(CC=C)C1(C2=CC=CC=C2C3=CC=CC=C31)C4=CC=CC=C4<SEP><PAD><PAD><PAD><PAD><PAD><PAD><PAD><PAD><PAD><PAD><PAD><PAD><PAD><PAD><PAD><PAD><PAD><PAD><PAD><PAD><PAD><PAD><PAD><PAD><PAD><PAD><PAD><PAD><PAD><PAD><PAD><PAD><PAD><PAD><PAD><PAD><PAD><PAD><PAD><PAD><PAD>
<CLS>C1=CC=C(C=C1)N2C(=O)C(=CC3=CC(=CC=C3)OC4=CC=CC=C4)SC2=O<SEP>CCCCCCCCCCCCCCCCCCCCCCCCCCCCCCCCCCCCCCCCCCC	<CLS>C1=CC=C(C=C1)N2C(=O)C(=CC3=CC(=CC=C3)OC4=CC=CC=C4)SC2=O<SEP><PAD><PAD><PAD><PAD><PAD><PAD><PAD><PAD><PAD><PAD><PAD><PAD><PAD><PAD><PAD><PAD><PAD><PAD><PAD><PAD><PAD><PAD><PAD><PAD><PAD><PAD><PAD><PAD><PAD><PAD><PAD><PAD><PAD><PAD><PAD><PAD><PAD><PAD><PAD><PAD><PAD><PAD><PAD>
<CLS>CC1=C(SC=N1)C[NH+](C)C(C)C(=O)NC2=CC=CC(=C2)CCN<SEP>CCCCCCCCCCCCCCCCCCCCCCCCCCCCCCCCCCCCCCCCCCCCCCCCCCC	<CLS>CC1=C(SC=C1)C[NH+](C)C(C)C(=O)NC2=CC=CC(=C2)C#N<SEP><PAD><PAD><PAD><PAD><PAD><PAD><PAD><PAD><PAD><PAD><PAD><PAD><PAD><PAD><PAD><PAD><PAD><PAD><PAD><PAD><PAD><PAD><PAD><PAD><PAD><PAD><PAD><PAD><PAD><PAD><PAD><PAD><PAD><PAD><PAD><PAD><PAD><PAD><PAD><PAD><PAD><PAD><PAD><PAD><PAD><PAD><PAD><PAD><PAD><PAD><PAD>
<CLS>CC1C2=C(C=CC(=C2)S(=O)(=O)NC(C)C3=CC=CC=C3Cl)NC1=O<SEP>CCCCCCCCCCCCCCCCCCCCCCCCCCCCCCCCCCCCCCCCCCCCCCCC	<CLS>CC1C2=C(C=CC(=C2)S(=O)(=O)NC(C)C3=CC=CC=C3Cl)NC1=O<SEP><PAD><PAD><PAD><PAD><PAD><PAD><PAD><PAD><PAD><PAD><PAD><PAD><PAD><PAD><PAD><PAD><PAD><PAD><PAD><PAD><PAD><PAD><PAD><PAD><PAD><PAD><PAD><PAD><PAD><PAD><PAD><PAD><PAD><PAD><PAD><PAD><PAD><PAD><PAD><PAD><PAD><PAD><PAD><PAD><PAD><PAD><PAD><PAD>
<CLS>CCOC(=O)C1=C(SC2=C1CCCC2)NC(=O)C3=CC(=CC=C3)N)C4=O)CCC4=O<SEP>CCCCCCCCCCCCCCCCCCCCCCCCCCCCCCCCCCCCCCCCC	<CLS>CCOC(=O)C1=C(SC2=C1CCCC2)NC(=O)C3=CC(=CC=C3)N4C(=O)CCC4=O<SEP><PAD><PAD><PAD><PAD><PAD><PAD><PAD><PAD><PAD><PAD><PAD><PAD><PAD><PAD><PAD><PAD><PAD><PAD><PAD><PAD><PAD><PAD><PAD><PAD><PAD><PAD><PAD><PAD><PAD><PAD><PAD><PAD><PAD><PAD><PAD><PAD><PAD><PAD><PAD><PAD><PAD>
<CLS>CC(=O)C1=C(C=C(C=C1)OCC2CN(CCO2)C(=O)COC3=CC4=CC=CC=C43)C(=O)C)C<SEP>CCCCCCCCCCCCCCCCCCCCCCCCCCCCCCCCCC	<CLS>CC(=O)C1=C(C=C(C=C1)OCC2CN(CCO2)C(=O)CCC3=NC4=CC=CC=C4N(C3=O)C)F<SEP><PAD><PAD><PAD><PAD><PAD><PAD><PAD><PAD><PAD><PAD><PAD><PAD><PAD><PAD><PAD><PAD><PAD><PAD><PAD><PAD><PAD><PAD><PAD><PAD><PAD><PAD><PAD><PAD><PAD><PAD><PAD><PAD><PAD><PAD>
<CLS>COCCNC(=O)NC(=O)CNC1=C(C=CC(=C1)Cl)OC2=CC=CC=C2<SEP>CCCCCCCCCCCCCCCCCCCCCCCCCCCCCCCCCCCCCCCCCCCCCCCCCCC	<CLS>COCCNC(=O)NC(=O)CNC1=C(C=CC(=C1)Cl)OC2=CC=CC=C2<SEP><PAD><PAD><PAD><PAD><PAD><PAD><PAD><PAD><PAD><PAD><PAD><PAD><PAD><PAD><PAD><PAD><PAD><PAD><PAD><PAD><PAD><PAD><PAD><PAD><PAD><PAD><PAD><PAD><PAD><PAD><PAD><PAD><PAD><PAD><PAD><PAD><PAD><PAD><PAD><PAD><PAD><PAD><PAD><PAD><PAD><PAD><PAD><PAD><PAD><PAD><PAD>
<CLS>CC(C)OC1=CC=C(C=C1)OCC(=O)NC(C)C(=O)NC2C3=CC=CC=C3C4=CC=CC=C4NC2=O<SEP>CCCCCCCCCCCCCCCCCCCCCCCCCCCCCCCC	<CLS>CC(C)OC1=CC=C(C=C1)OCC(=O)NC(C)C(=O)NC2C3=CC=CC=C3C4=CC=CC=C4NC2=O<SEP><PAD><PAD><PAD><PAD><PAD><PAD><PAD><PAD><PAD><PAD><PAD><PAD><PAD><PAD><PAD><PAD><PAD><PAD><PAD><PAD><PAD><PAD><PAD><PAD><PAD><PAD><PAD><PAD><PAD><PAD><PAD><PAD>
<CLS>COC1=C(C=CC(=C1)C=NNC(=O)C(OC2=CC=C(C=C2)Cl)(C3=CC=C(C=C3)Cl)OCC4=CC=C(C=C4)CC<SEP>CCCCCCCCCCCCCCCCCCCC	<CLS>COC1=C(C=CC(=C1)C=NNC(=O)C(OC2=CC=C(C=C2)Cl)OC3=CC=C(C=C3)Cl)OCC4=CC=C(C=C4)Cl<SEP><PAD><PAD><PAD><PAD><PAD><PAD><PAD><PAD><PAD><PAD><PAD><PAD><PAD><PAD><PAD><PAD><PAD><PAD><PAD><PAD>
<CLS>COC1=CC(=C(C=C1)C(NCC2=C(C(=CC=C2)F)O)C(=O)C3=CC=CC=3)N4C=CN=C4)OC<SEP>CCCCCCCCCCCCCCCCCCCCCCCCCCCCCCCC	<CLS>COC1=CC(=C(C=C1)CN(CC2=C(C(=CC=C2)F)F)C(=O)C3=CC=CC=C3N4C=CC=C4)OC<SEP><PAD><PAD><PAD><PAD><PAD><PAD><PAD><PAD><PAD><PAD><PAD><PAD><PAD><PAD><PAD><PAD><PAD><PAD><PAD><PAD><PAD><PAD><PAD><PAD><PAD><PAD><PAD><PAD><PAD><PAD><PAD><PAD>
<CLS>CC1=CC=C(C=C1)C(=C2C(N(C(=O)N2)O)C3=NC=CS3)C4=CC(=CC=C4)Br)O<SEP>CCCCCCCCCCCCCCCCCCCCCCCCCCCCCCCCCCCCCC	<CLS>CC1=CC=C(C=C1)C(=C2C(N(C(=O)C2=O)C3=NN=CS3)C4=CC(=CC=C4)Br)O<SEP><PAD><PAD><PAD><PAD><PAD><PAD><PAD><PAD><PAD><PAD><PAD><PAD><PAD><PAD><PAD><PAD><PAD><PAD><PAD><PAD><PAD><PAD><PAD><PAD><PAD><PAD><PAD><PAD><PAD><PAD><PAD><PAD><PAD><PAD><PAD><PAD><PAD><PAD>
<CLS>CC1=CC(=CC(=C1)C2=CC3=C(C=C2)N=CN3)C(=O)NCCN(C)C4CCCCC4)C<SEP>CCCCCCCCCCCCCCCCCCCCCCCCCCCCCCCCCCCCCCCCC	<CLS>CC1=CC(=CC(=C1)C2=CC3=C(C=C2)C=CN3CC(=O)NCCN(C)C4CCCCC4)C<SEP><PAD><PAD><PAD><PAD><PAD><PAD><PAD><PAD><PAD><PAD><PAD><PAD><PAD><PAD><PAD><PAD><PAD><PAD><PAD><PAD><PAD><PAD><PAD><PAD><PAD><PAD><PAD><PAD><PAD><PAD><PAD><PAD><PAD><PAD><PAD><PAD><PAD><PAD><PAD><PAD><PAD>
<CLS>CN1C=NC2=C(C1=O)C(=CS2)C3=CC=C(C=C3)F<SEP>CCCCCCCCCCCCCCCCCCCCCCCCCCCCCCCCCCCCCCCCCCCCCCCCCCCCCCCCCCCCC	<CLS>CN1C=NC2=C(C1=O)C(=CS2)C3=CC=C(C=C3)F<SEP><PAD><PAD><PAD><PAD><PAD><PAD><PAD><PAD><PAD><PAD><PAD><PAD><PAD><PAD><PAD><PAD><PAD><PAD><PAD><PAD><PAD><PAD><PAD><PAD><PAD><PAD><PAD><PAD><PAD><PAD><PAD><PAD><PAD><PAD><PAD><PAD><PAD><PAD><PAD><PAD><PAD><PAD><PAD><PAD><PAD><PAD><PAD><PAD><PAD><PAD><PAD><PAD><PAD><PAD><PAD><PAD><PAD><PAD><PAD><PAD><PAD>
<CLS>CCC(C1=C2COCN(C2=NC(=N1)C)C3=CC(=C(C=C3F)C)C)O<SEP>CCCCCCCCCCCCCCCCCCCCCCCCCCCCCCCCCCCCCCCCCCCCCCCCCCCC	<CLS>CCC(C1=C2COCN(C2=NC(=N1)C)C3=C(C=C(C=C3C)C)C)O<SEP><PAD><PAD><PAD><PAD><PAD><PAD><PAD><PAD><PAD><PAD><PAD><PAD><PAD><PAD><PAD><PAD><PAD><PAD><PAD><PAD><PAD><PAD><PAD><PAD><PAD><PAD><PAD><PAD><PAD><PAD><PAD><PAD><PAD><PAD><PAD><PAD><PAD><PAD><PAD><PAD><PAD><PAD><PAD><PAD><PAD><PAD><PAD><PAD><PAD><PAD><PAD><PAD>
<CLS>C1CN(CCN1C2=CC=C(C=C2)N3C=CN=C3O)C4=CC=C(C=C4)F<SEP>CCCCCCCCCCCCCCCCCCCCCCCCCCCCCCCCCCCCCCCCCCCCCCCCCCC	<CLS>C1CN(CCN1C2=CC=C(C=C2)N3C=NNC3=O)C4=CC=C(C=C4)O<SEP><PAD><PAD><PAD><PAD><PAD><PAD><PAD><PAD><PAD><PAD><PAD><PAD><PAD><PAD><PAD><PAD><PAD><PAD><PAD><PAD><PAD><PAD><PAD><PAD><PAD><PAD><PAD><PAD><PAD><PAD><PAD><PAD><PAD><PAD><PAD><PAD><PAD><PAD><PAD><PAD><PAD><PAD><PAD><PAD><PAD><PAD><PAD><PAD><PAD><PAD><PAD>
<CLS>CN(C1=CC(=CC=C1)Cl)C2=NC(=NC3=CC=CC=C32)NCCC4=CC=C(C=C4)S(=OCC=O)C<SEP>CCCCCCCCCCCCCCCCCCCCCCCCCCCCCCCC	<CLS>CN(C1=CC(=CC=C1)Cl)C2=NC(=NC3=CC=CC=C32)NCCC4=CC=C(C=C4)S(=O)(=O)N<SEP><PAD><PAD><PAD><PAD><PAD><PAD><PAD><PAD><PAD><PAD><PAD><PAD><PAD><PAD><PAD><PAD><PAD><PAD><PAD><PAD><PAD><PAD><PAD><PAD><PAD><PAD><PAD><PAD><PAD><PAD><PAD><PAD>
<CLS>CC1=CC=C(N1C2=CC=C(C=C2)C(=O)N3CCN(CC3)S(=O)(=O)N4CCOCC4)C<SEP>CCCCCCCCCCCCCCCCCCCCCCCCCCCCCCCCCCCCCCCC	<CLS>CC1=CC=C(N1C2=CC=C(C=C2)C(=O)N3CCN(CC3)S(=O)(=O)N4CCOCC4)C<SEP><PAD><PAD><PAD><PAD><PAD><PAD><PAD><PAD><PAD><PAD><PAD><PAD><PAD><PAD><PAD><PAD><PAD><PAD><PAD><PAD><PAD><PAD><PAD><PAD><PAD><PAD><PAD><PAD><PAD><PAD><PAD><PAD><PAD><PAD><PAD><PAD><PAD><PAD><PAD><PAD>
<CLS>C1CC=CCC(C(=O)NC(COC(=O)C1)CC2=CC=C(C=C2)OCC3=CC=CC=C3)CC(=O)N4CC5=CC=CCC45CC4CO<SEP>CCCCCCCCCCCCCCCCCC	<CLS>C1CC=CCC(C(=O)NC(COC(=O)C1)CC2=CC=C(C=C2)OCC3=CC=CC=C3)CC(=O)N4CC5=CC=CC=C5CC4CO<SEP><PAD><PAD><PAD><PAD><PAD><PAD><PAD><PAD><PAD><PAD><PAD><PAD><PAD><PAD><PAD><PAD><PAD><PAD>
<CLS>CC(=NOCCOC1=CC=C(C=C1)CN(C(CC2=CC=CC=C2)C(=O)O)C3=CC=C(C=C3)C4=CC=CC=N4<SEP>CCCCCCCCCCCCCCCCCCCCCCCCCCC	<CLS>CC(=NOCCOC1=CC=C(C=C1)CC(CCCC2=CC=CC=C2)C(=O)O)C3=CC=C(C=C3)C4=CC=CC=N4<SEP><PAD><PAD><PAD><PAD><PAD><PAD><PAD><PAD><PAD><PAD><PAD><PAD><PAD><PAD><PAD><PAD><PAD><PAD><PAD><PAD><PAD><PAD><PAD><PAD><PAD><PAD><PAD>
<CLS>CCCCC1=NN=C2N1C=C3C(=N2)C4=CC=CC=C4C3=NOCC=C<SEP>CCCCCCCCCCCCCCCCCCCCCCCCCCCCCCCCCCCCCCCCCCCCCCCCCCCCCC	<CLS>CCCCC1=NN=C2N1N=C3C(=N2)C4=CC=CC=C4C3=NOCC=C<SEP><PAD><PAD><PAD><PAD><PAD><PAD><PAD><PAD><PAD><PAD><PAD><PAD><PAD><PAD><PAD><PAD><PAD><PAD><PAD><PAD><PAD><PAD><PAD><PAD><PAD><PAD><PAD><PAD><PAD><PAD><PAD><PAD><PAD><PAD><PAD><PAD><PAD><PAD><PAD><PAD><PAD><PAD><PAD><PAD><PAD><PAD><PAD><PAD><PAD><PAD><PAD><PAD><PAD><PAD>
<CLS>CCOC(=O)C1=C(NC(=C(C1C2=CC(=CC=C2)F)C#N)N)CCl<SEP>CCCCCCCCCCCCCCCCCCCCCCCCCCCCCCCCCCCCCCCCCCCCCCCCCCCCC	<CLS>CCOC(=O)C1=C(OC(=C(C1C2=CC(=CC=C2)F)C#N)N)CCl<SEP><PAD><PAD><PAD><PAD><PAD><PAD><PAD><PAD><PAD><PAD><PAD><PAD><PAD><PAD><PAD><PAD><PAD><PAD><PAD><PAD><PAD><PAD><PAD><PAD><PAD><PAD><PAD><PAD><PAD><PAD><PAD><PAD><PAD><PAD><PAD><PAD><PAD><PAD><PAD><PAD><PAD><PAD><PAD><PAD><PAD><PAD><PAD><PAD><PAD><PAD><PAD><PAD><PAD>
<CLS>CN1CCN(CC1)CCCC(=O)NC2=CC=CC=C2N<SEP>CCCCCCCCCCCCCCCCCCCCCCCCCCCCCCCCCCCCCCCCCCCCCCCCCCCCCCCCCCCCCCCCCC	<CLS>CC1CCN(CC1)CCCC(=O)NC2=CC=CC=C2N<SEP><PAD><PAD><PAD><PAD><PAD><PAD><PAD><PAD><PAD><PAD><PAD><PAD><PAD><PAD><PAD><PAD><PAD><PAD><PAD><PAD><PAD><PAD><PAD><PAD><PAD><PAD><PAD><PAD><PAD><PAD><PAD><PAD><PAD><PAD><PAD><PAD><PAD><PAD><PAD><PAD><PAD><PAD><PAD><PAD><PAD><PAD><PAD><PAD><PAD><PAD><PAD><PAD><PAD><PAD><PAD><PAD><PAD><PAD><PAD><PAD><PAD><PAD><PAD><PAD><PAD><PAD>
<CLS>CC1(OCCO1)CCC=CC2=CC=C(C=C2)OC<SEP>CCCCCCCCCCCCCCCCCCCCCCCCCCCCCCCCCCCCCCCCCCCCCCCCCCCCCCCCCCCCCCCCCCCC	<CLS>CC1(OCCO1)CCC=CC2=CC=C(C=C2)OC<SEP><PAD><PAD><PAD><PAD><PAD><PAD><PAD><PAD><PAD><PAD><PAD><PAD><PAD><PAD><PAD><PAD><PAD><PAD><PAD><PAD><PAD><PAD><PAD><PAD><PAD><PAD><PAD><PAD><PAD><PAD><PAD><PAD><PAD><PAD><PAD><PAD><PAD><PAD><PAD><PAD><PAD><PAD><PAD><PAD><PAD><PAD><PAD><PAD><PAD><PAD><PAD><PAD><PAD><PAD><PAD><PAD><PAD><PAD><PAD><PAD><PAD><PAD><PAD><PAD><PAD><PAD><PAD><PAD>
<CLS>C1C(NC2=NC(=NN2CCC(F)(F)F)C(=O)NC3=CC(=C(C=C3)Cl)Cl)C4=CC(=C(C=C4)Cl)CC<SEP>CCCCCCCCCCCCCCCCCCCCCCCCCCC	<CLS>C1C(NC2=CC(=NN2C1C(F)(F)F)C(=O)NC3=CC(=C(C=C3)Cl)Cl)C4=CC(=C(C=C4)Cl)Cl<SEP><PAD><PAD><PAD><PAD><PAD><PAD><PAD><PAD><PAD><PAD><PAD><PAD><PAD><PAD><PAD><PAD><PAD><PAD><PAD><PAD><PAD><PAD><PAD><PAD><PAD><PAD><PAD>
<CLS>CC(=O)N1CC(=O)NC2=C1C=CC(=C2)Cl<SEP>CCCCCCCCCCCCCCCCCCCCCCCCCCCCCCCCCCCCCCCCCCCCCCCCCCCCCCCCCCCCCCCCCCC	<CLS>CC(=O)N1CC(=O)NC2=C1C=CC(=C2)Cl<SEP><PAD><PAD><PAD><PAD><PAD><PAD><PAD><PAD><PAD><PAD><PAD><PAD><PAD><PAD><PAD><PAD><PAD><PAD><PAD><PAD><PAD><PAD><PAD><PAD><PAD><PAD><PAD><PAD><PAD><PAD><PAD><PAD><PAD><PAD><PAD><PAD><PAD><PAD><PAD><PAD><PAD><PAD><PAD><PAD><PAD><PAD><PAD><PAD><PAD><PAD><PAD><PAD><PAD><PAD><PAD><PAD><PAD><PAD><PAD><PAD><PAD><PAD><PAD><PAD><PAD><PAD><PAD>
<CLS>CC(C#N)(C1CC1)NC(=O)COC(=O)C2=CC3=C(S2)C4=CC=CC=C4CC3<SEP>CCCCCCCCCCCCCCCCCCCCCCCCCCCCCCCCCCCCCCCCCCCCC	<CLS>CC(C#N)(C1CC1)NC(=O)COC(=O)C2=CC3=C(S2)C4=CC=CC=C4CC3<SEP><PAD><PAD><PAD><PAD><PAD><PAD><PAD><PAD><PAD><PAD><PAD><PAD><PAD><PAD><PAD><PAD><PAD><PAD><PAD><PAD><PAD><PAD><PAD><PAD><PAD><PAD><PAD><PAD><PAD><PAD><PAD><PAD><PAD><PAD><PAD><PAD><PAD><PAD><PAD><PAD><PAD><PAD><PAD><PAD><PAD>
<CLS>CS(=O)(=O)NC1CCN(CC1)C2=C(C(=CC=C2)Cl)C3=NOC(C3)C4=CC(=CC=C4)NC(=O)C(Cl)Cl<SEP>CCCCCCCCCCCCCCCCCCCCCCCC	<CLS>CS(=O)(=O)NC1CCN(CC1)C2=C(C(=CC=C2)Cl)C3=NOC(C3)C4=CC(=CC=C4)NC(=O)C(Cl)Cl<SEP><PAD><PAD><PAD><PAD><PAD><PAD><PAD><PAD><PAD><PAD><PAD><PAD><PAD><PAD><PAD><PAD><PAD><PAD><PAD><PAD><PAD><PAD><PAD><PAD>
<CLS>CN1C2=C(C=C(C=C2)F)SC1=NS(=O)(=O)C3=CC=C(S3)Cl<SEP>CCCCCCCCCCCCCCCCCCCCCCCCCCCCCCCCCCCCCCCCCCCCCCCCCCCC	<CLS>CN1C2=C(C=C(C=C2)F)SC1=NS(=O)(=O)C3=CC=C(S3)Cl<SEP><PAD><PAD><PAD><PAD><PAD><PAD><PAD><PAD><PAD><PAD><PAD><PAD><PAD><PAD><PAD><PAD><PAD><PAD><PAD><PAD><PAD><PAD><PAD><PAD><PAD><PAD><PAD><PAD><PAD><PAD><PAD><PAD><PAD><PAD><PAD><PAD><PAD><PAD><PAD><PAD><PAD><PAD><PAD><PAD><PAD><PAD><PAD><PAD><PAD><PAD><PAD><PAD>
<CLS>CC1=CC=C(O1)CN(C)C(=O)C2=CC(=C(C=C2[N+](=O)[O-])OC)OC<SEP>CCCCCCCCCCCCCCCCCCCCCCCCCCCCCCCCCCCCCCCCCCCCC	<CLS>CC1=CC=C(O1)CN(C)C(=O)C2=CC(=C(C=C2[N+](=O)[O-])OC)OC<SEP><PAD><PAD><PAD><PAD><PAD><PAD><PAD><PAD><PAD><PAD><PAD><PAD><PAD><PAD><PAD><PAD><PAD><PAD><PAD><PAD><PAD><PAD><PAD><PAD><PAD><PAD><PAD><PAD><PAD><PAD><PAD><PAD><PAD><PAD><PAD><PAD><PAD><PAD><PAD><PAD><PAD><PAD><PAD><PAD><PAD>
<CLS>C1CN(C2=CC=CC=C21)S(=O)(=O)C3=CC=C(C=C3)C(=O)NC4=NN=C(O4)C5=CC=C(C=C5)Br<SEP>CCCCCCCCCCCCCCCCCCCCCCCCCC	<CLS>C1CN(C2=CC=CC=C21)S(=O)(=O)C3=CC=C(C=C3)C(=O)NC4=NN=C(O4)C5=CC=C(C=C5)Br<SEP><PAD><PAD><PAD><PAD><PAD><PAD><PAD><PAD><PAD><PAD><PAD><PAD><PAD><PAD><PAD><PAD><PAD><PAD><PAD><PAD><PAD><PAD><PAD><PAD><PAD><PAD>
<CLS>CCCCOC1=C(C=C(C=C1)C2C(=C(C3=CC=C(C=C3)Cl)C)C(=O)C(=O)N2CCC4=COCCCCOC<SEP>CCCCCCCCCCCCCCCCCCCCCCCCCCCCC	<CLS>CCCCOC1=C(C=C(C=C1)C2C(=C(C3=CC=C(C=C3)Cl)O)C(=O)C(=O)N2CCN4CCOCC4)OC<SEP><PAD><PAD><PAD><PAD><PAD><PAD><PAD><PAD><PAD><PAD><PAD><PAD><PAD><PAD><PAD><PAD><PAD><PAD><PAD><PAD><PAD><PAD><PAD><PAD><PAD><PAD><PAD><PAD><PAD>
<CLS>CCN(CC)C1=CC=C(C=C1)C=C2C(=O)N(C(=NC==S3)C4=CC(=CC=C4)Cl)S2<SEP>CCCCCCCCCCCCCCCCCCCCCCCCCCCCCCCCCCCCCCC	<CLS>CCN(CC)C1=CC=C(C=C1)C=C2C(=O)N3C(=NC(=N3)C4=CC(=CC=C4)Cl)S2<SEP><PAD><PAD><PAD><PAD><PAD><PAD><PAD><PAD><PAD><PAD><PAD><PAD><PAD><PAD><PAD><PAD><PAD><PAD><PAD><PAD><PAD><PAD><PAD><PAD><PAD><PAD><PAD><PAD><PAD><PAD><PAD><PAD><PAD><PAD><PAD><PAD><PAD><PAD><PAD>
<CLS>CC(C)CC(=O)NC(=O)NNC(=O)C1=CC=NC=C1<SEP>CCCCCCCCCCCCCCCCCCCCCCCCCCCCCCCCCCCCCCCCCCCCCCCCCCCCCCCCCCCCCCC	<CLS>CC(C)CC(=O)NC(=S)NNC(=O)C1=CC=NC=C1<SEP><PAD><PAD><PAD><PAD><PAD><PAD><PAD><PAD><PAD><PAD><PAD><PAD><PAD><PAD><PAD><PAD><PAD><PAD><PAD><PAD><PAD><PAD><PAD><PAD><PAD><PAD><PAD><PAD><PAD><PAD><PAD><PAD><PAD><PAD><PAD><PAD><PAD><PAD><PAD><PAD><PAD><PAD><PAD><PAD><PAD><PAD><PAD><PAD><PAD><PAD><PAD><PAD><PAD><PAD><PAD><PAD><PAD><PAD><PAD><PAD><PAD><PAD><PAD>
<CLS>CCCCCCN1C2C(C(=O)N(C2=O)C3=CC=CC=C3)ON1C4=CC(=C(C=C4)Cl)Cl<SEP>CCCCCCCCCCCCCCCCCCCCCCCCCCCCCCCCCCCCCCCC	<CLS>CCCCCCC1C2C(C(=O)N(C2=O)C3=CC=CC=C3)ON1C4=CC(=C(C=C4)Cl)Cl<SEP><PAD><PAD><PAD><PAD><PAD><PAD><PAD><PAD><PAD><PAD><PAD><PAD><PAD><PAD><PAD><PAD><PAD><PAD><PAD><PAD><PAD><PAD><PAD><PAD><PAD><PAD><PAD><PAD><PAD><PAD><PAD><PAD><PAD><PAD><PAD><PAD><PAD><PAD><PAD><PAD>
<CLS>C#CCSCC1=NC2=CC=CC=C2N1<SEP>CCCCCCCCCCCCCCCCCCCCCCCCCCCCCCCCCCCCCCCCCCCCCCCCCCCCCCCCCCCCCCCCCCCCCCCCCCC	<CLS>C#CCSCC1=NC2=CC=CC=C2N1<SEP><PAD><PAD><PAD><PAD><PAD><PAD><PAD><PAD><PAD><PAD><PAD><PAD><PAD><PAD><PAD><PAD><PAD><PAD><PAD><PAD><PAD><PAD><PAD><PAD><PAD><PAD><PAD><PAD><PAD><PAD><PAD><PAD><PAD><PAD><PAD><PAD><PAD><PAD><PAD><PAD><PAD><PAD><PAD><PAD><PAD><PAD><PAD><PAD><PAD><PAD><PAD><PAD><PAD><PAD><PAD><PAD><PAD><PAD><PAD><PAD><PAD><PAD><PAD><PAD><PAD><PAD><PAD><PAD><PAD><PAD><PAD><PAD><PAD><PAD><PAD>
<CLS>CC1=CC(=C(C(=C1)OCC(CNCCCCCCCCCC2)O)C)C<SEP>CCCCCCCCCCCCCCCCCCCCCCCCCCCCCCCCCCCCCCCCCCCCCCCCCCCCCCCCCCC	<CLS>CC1=CC(=C(C(=C1)OCC(CN(C)C2CCCCC2)O)C)C<SEP><PAD><PAD><PAD><PAD><PAD><PAD><PAD><PAD><PAD><PAD><PAD><PAD><PAD><PAD><PAD><PAD><PAD><PAD><PAD><PAD><PAD><PAD><PAD><PAD><PAD><PAD><PAD><PAD><PAD><PAD><PAD><PAD><PAD><PAD><PAD><PAD><PAD><PAD><PAD><PAD><PAD><PAD><PAD><PAD><PAD><PAD><PAD><PAD><PAD><PAD><PAD><PAD><PAD><PAD><PAD><PAD><PAD><PAD><PAD>
<CLS>CC(C)S(=O)(=O)C1=CC=C(C=C1)C2=NN=C(O2)NC(=O)C3=CC=C(S3)Br<SEP>CCCCCCCCCCCCCCCCCCCCCCCCCCCCCCCCCCCCCCCCC	<CLS>CC(C)S(=O)(=O)C1=CC=C(C=C1)C2=NN=C(O2)NC(=O)C3=CC=C(S3)Br<SEP><PAD><PAD><PAD><PAD><PAD><PAD><PAD><PAD><PAD><PAD><PAD><PAD><PAD><PAD><PAD><PAD><PAD><PAD><PAD><PAD><PAD><PAD><PAD><PAD><PAD><PAD><PAD><PAD><PAD><PAD><PAD><PAD><PAD><PAD><PAD><PAD><PAD><PAD><PAD><PAD><PAD>
<CLS>CC1CC(N(C2=C1C=C(C=C2)NC(=O)C)CCOC(=O)C)(C)C<SEP>CCCCCCCCCCCCCCCCCCCCCCCCCCCCCCCCCCCCCCCCCCCCCCCCCCCCCC	<CLS>CC1CC(N(C2=C1C=CC(=C2)NC(=O)C)CCOC(=O)C)(C)C<SEP><PAD><PAD><PAD><PAD><PAD><PAD><PAD><PAD><PAD><PAD><PAD><PAD><PAD><PAD><PAD><PAD><PAD><PAD><PAD><PAD><PAD><PAD><PAD><PAD><PAD><PAD><PAD><PAD><PAD><PAD><PAD><PAD><PAD><PAD><PAD><PAD><PAD><PAD><PAD><PAD><PAD><PAD><PAD><PAD><PAD><PAD><PAD><PAD><PAD><PAD><PAD><PAD><PAD><PAD>
<CLS>CCOC(=O)C1=C(SC2=C1C=CS2)NC(=O)CSC3=NN=C(N3CC4=CC=CO4)C5=CC=CC=C5<SEP>CCCCCCCCCCCCCCCCCCCCCCCCCCCCCCCCC	<CLS>CCOC(=O)C1=C(SC2=C1CCCC2)NC(=O)CSC3=NN=C(N3CC4=CC=CO4)C5=CC=NC=C5<SEP><PAD><PAD><PAD><PAD><PAD><PAD><PAD><PAD><PAD><PAD><PAD><PAD><PAD><PAD><PAD><PAD><PAD><PAD><PAD><PAD><PAD><PAD><PAD><PAD><PAD><PAD><PAD><PAD><PAD><PAD><PAD><PAD><PAD>
<CLS>CC1C(C(C(C(O1)OC2=CC3=C(C(=C2)O)C(=O)C4=C(C3=O)C=C(C=C4O)O)O)O)O<SEP>CCCCCCCCCCCCCCCCCCCCCCCCCCCCCCCCCC	<CLS>CC1C(C(C(C(O1)OC2=CC3=C(C(=C2)O)C(=O)C4=C(C3=O)C=C(C=C4O)C)O)O)O<SEP><PAD><PAD><PAD><PAD><PAD><PAD><PAD><PAD><PAD><PAD><PAD><PAD><PAD><PAD><PAD><PAD><PAD><PAD><PAD><PAD><PAD><PAD><PAD><PAD><PAD><PAD><PAD><PAD><PAD><PAD><PAD><PAD><PAD><PAD>
<CLS>CC(C(=O)NC1=CC=CC2=CC=CC=C21)N3CCN(CC3)S(=O)(=O)C4=CC=CC=C4<SEP>CCCCCCCCCCCCCCCCCCCCCCCCCCCCCCCCCCCCCCC	<CLS>CC(C(=O)NC1=CC=CC2=CC=CC=C21)N3CCN(CC3)S(=O)(=O)C4=CC=CC=C4<SEP><PAD><PAD><PAD><PAD><PAD><PAD><PAD><PAD><PAD><PAD><PAD><PAD><PAD><PAD><PAD><PAD><PAD><PAD><PAD><PAD><PAD><PAD><PAD><PAD><PAD><PAD><PAD><PAD><PAD><PAD><PAD><PAD><PAD><PAD><PAD><PAD><PAD><PAD><PAD>
<CLS>CCS(=O)(=O)C1=CC2=C(C=C1)OC(=N2)CCC(=O)NC3=C(C=C(C=C3)C)CC+](CO)[O-C<SEP>CCCCCCCCCCCCCCCCCCCCCCCCCCCCCC	<CLS>CCS(=O)(=O)C1=CC2=C(C=C1)OC(=N2)SCC(=O)NC3=C(C=C(C=C3)C)[N+](=O)[O-]<SEP><PAD><PAD><PAD><PAD><PAD><PAD><PAD><PAD><PAD><PAD><PAD><PAD><PAD><PAD><PAD><PAD><PAD><PAD><PAD><PAD><PAD><PAD><PAD><PAD><PAD><PAD><PAD><PAD><PAD><PAD>
<CLS>C1CNCC2=C1C3=CC=CC=C3N2C(=O)N.C(=O)(C(F)(F)F)O<SEP>CCCCCCCCCCCCCCCCCCCCCCCCCCCCCCCCCCCCCCCCCCCCCCCCCCCC	<CLS>C1CNCC2=C1C3=CC=CC=C3N2C(=O)N.C(=O)(C(F)(F)F)O<SEP><PAD><PAD><PAD><PAD><PAD><PAD><PAD><PAD><PAD><PAD><PAD><PAD><PAD><PAD><PAD><PAD><PAD><PAD><PAD><PAD><PAD><PAD><PAD><PAD><PAD><PAD><PAD><PAD><PAD><PAD><PAD><PAD><PAD><PAD><PAD><PAD><PAD><PAD><PAD><PAD><PAD><PAD><PAD><PAD><PAD><PAD><PAD><PAD><PAD><PAD><PAD><PAD>
<CLS>C1=CC(=C(C(=C1)F)C(=O)NC(=O)NC2=CC3=C(C=C2)OC(O3)(F)F)F<SEP>CCCCCCCCCCCCCCCCCCCCCCCCCCCCCCCCCCCCCCCCCCC	<CLS>C1=CC(=C(C(=C1)F)C(=O)NC(=O)NC2=CC3=C(C=C2)OC(O3)(F)F)F<SEP><PAD><PAD><PAD><PAD><PAD><PAD><PAD><PAD><PAD><PAD><PAD><PAD><PAD><PAD><PAD><PAD><PAD><PAD><PAD><PAD><PAD><PAD><PAD><PAD><PAD><PAD><PAD><PAD><PAD><PAD><PAD><PAD><PAD><PAD><PAD><PAD><PAD><PAD><PAD><PAD><PAD><PAD><PAD>
<CLS>COC1=C(C(=CC(=C1)C(C([N+](=O)[O-])Br)Br)OC2=C(C=C(C=C2I)CC(=O)OC)O)O<SEP>CCCCCCCCCCCCCCCCCCCCCCCCCCCCCC	<CLS>COC1=C(C(=CC(=C1)C(C([N+](=O)[O-])Br)Br)OC2=C(C=C(C=C2I)CC(=O)OC)I)O<SEP><PAD><PAD><PAD><PAD><PAD><PAD><PAD><PAD><PAD><PAD><PAD><PAD><PAD><PAD><PAD><PAD><PAD><PAD><PAD><PAD><PAD><PAD><PAD><PAD><PAD><PAD><PAD><PAD><PAD><PAD>
<CLS>CCC(=NNC(=O)NC1=CC=CC=C1)C2=C(N(C(=O)NC2=O)C3=CC=C(C=C3)C)C<SEP>CCCCCCCCCCCCCCCCCCCCCCCCCCCCCCCCCCCCCCC	<CLS>CCC(=NNC(=O)NC1=CC=CC=C1)C2=C(N(C(=O)NC2=O)C3=CC=C(C=C3)C)O<SEP><PAD><PAD><PAD><PAD><PAD><PAD><PAD><PAD><PAD><PAD><PAD><PAD><PAD><PAD><PAD><PAD><PAD><PAD><PAD><PAD><PAD><PAD><PAD><PAD><PAD><PAD><PAD><PAD><PAD><PAD><PAD><PAD><PAD><PAD><PAD><PAD><PAD><PAD><PAD>
<CLS>COC(=O)C(CC1=CC=C(C=C1)C2=CC=C(C=C2)CN(CC(=O)O)C(=O)OCCNC(=O)C3=CC=CC=C3Cl<SEP>CCCCCCCCCCCCCCCCCCCCCCCC	<CLS>COC(=O)C(CC1=CC=C(C=C1)C2=CC=C(C=C2)CN(CC(=O)O)C(=O)OC)NC(=O)C3=CC=CC=C3Cl<SEP><PAD><PAD><PAD><PAD><PAD><PAD><PAD><PAD><PAD><PAD><PAD><PAD><PAD><PAD><PAD><PAD><PAD><PAD><PAD><PAD><PAD><PAD><PAD><PAD>
<CLS>C1CC1C2=NC(=NN2CCC#N)C(F)(F)F<SEP>CCCCCCCCCCCCCCCCCCCCCCCCCCCCCCCCCCCCCCCCCCCCCCCCCCCCCCCCCCCCCCCCCCCCC	<CLS>C1CC1C2=CC(=NN2CCC#N)C(F)(F)F<SEP><PAD><PAD><PAD><PAD><PAD><PAD><PAD><PAD><PAD><PAD><PAD><PAD><PAD><PAD><PAD><PAD><PAD><PAD><PAD><PAD><PAD><PAD><PAD><PAD><PAD><PAD><PAD><PAD><PAD><PAD><PAD><PAD><PAD><PAD><PAD><PAD><PAD><PAD><PAD><PAD><PAD><PAD><PAD><PAD><PAD><PAD><PAD><PAD><PAD><PAD><PAD><PAD><PAD><PAD><PAD><PAD><PAD><PAD><PAD><PAD><PAD><PAD><PAD><PAD><PAD><PAD><PAD><PAD><PAD>
<CLS>CNS(=O)(=O)C1=CC=CC(=C1)C(=O)OCC(=O)N2CCCN3C=CC=C3<SEP>CCCCCCCCCCCCCCCCCCCCCCCCCCCCCCCCCCCCCCCCCCCCCCCC	<CLS>CNS(=O)(=O)C1=CC=CC(=C1)C(=O)OCC(=O)N2CCCC3C2CCCC3<SEP><PAD><PAD><PAD><PAD><PAD><PAD><PAD><PAD><PAD><PAD><PAD><PAD><PAD><PAD><PAD><PAD><PAD><PAD><PAD><PAD><PAD><PAD><PAD><PAD><PAD><PAD><PAD><PAD><PAD><PAD><PAD><PAD><PAD><PAD><PAD><PAD><PAD><PAD><PAD><PAD><PAD><PAD><PAD><PAD><PAD><PAD><PAD><PAD>
<CLS>CC1=C(C(=CC=C1)NC(=O)CN(CC2CCCO2)C(=O)C3=C((=NN3C4=CC=CC=C4)C5CC5)C<SEP>CCCCCCCCCCCCCCCCCCCCCCCCCCCCCCC	<CLS>CC1=C(C(=CC=C1)NC(=O)CN(CC2CCCO2)C(=O)C3=CC(=NN3C4=CC=CC=C4)C5CC5)C<SEP><PAD><PAD><PAD><PAD><PAD><PAD><PAD><PAD><PAD><PAD><PAD><PAD><PAD><PAD><PAD><PAD><PAD><PAD><PAD><PAD><PAD><PAD><PAD><PAD><PAD><PAD><PAD><PAD><PAD><PAD><PAD>
<CLS>CCOC1=CC=C(C=C1)C2C3=C(C4=CC=CC=C4S2)SC5=NC=CN5))C6=CC=CC=C6<SEP>CCCCCCCCCCCCCCCCCCCCCCCCCCCCCCCCCCCCCC	<CLS>CCOC1=CC=C(C=C1)C2C3=C(C4=CC=CC=C4O2)NC5=NC=NN5C3C6=CC=CC=C6<SEP><PAD><PAD><PAD><PAD><PAD><PAD><PAD><PAD><PAD><PAD><PAD><PAD><PAD><PAD><PAD><PAD><PAD><PAD><PAD><PAD><PAD><PAD><PAD><PAD><PAD><PAD><PAD><PAD><PAD><PAD><PAD><PAD><PAD><PAD><PAD><PAD><PAD><PAD>
<CLS>CCOC1=CC=CC=C1C2=NCCN=C(O2)N=C(N)NC3=CC(=C(C=C3)F)Cl)(C(F)(F)F)C(F)(F)F<SEP>CCCCCCCCCCCCCCCCCCCCCCCCCCC	<CLS>CCOC1=CC=CC=C1C2=NC(N=C(O2)N=C(N)NC3=CC(=C(C=C3)F)Cl)(C(F)(F)F)C(F)(F)F<SEP><PAD><PAD><PAD><PAD><PAD><PAD><PAD><PAD><PAD><PAD><PAD><PAD><PAD><PAD><PAD><PAD><PAD><PAD><PAD><PAD><PAD><PAD><PAD><PAD><PAD><PAD><PAD>
<CLS>CNS(=O)(=O)C1=CC=C(C=C1)C(=O)NCC(CC(F)(F)F<SEP>CCCCCCCCCCCCCCCCCCCCCCCCCCCCCCCCCCCCCCCCCCCCCCCCCCCCCCCC	<CLS>CNS(=O)(=O)C1=CC=C(C=C1)C(=O)NCCOCC(F)(F)F<SEP><PAD><PAD><PAD><PAD><PAD><PAD><PAD><PAD><PAD><PAD><PAD><PAD><PAD><PAD><PAD><PAD><PAD><PAD><PAD><PAD><PAD><PAD><PAD><PAD><PAD><PAD><PAD><PAD><PAD><PAD><PAD><PAD><PAD><PAD><PAD><PAD><PAD><PAD><PAD><PAD><PAD><PAD><PAD><PAD><PAD><PAD><PAD><PAD><PAD><PAD><PAD><PAD><PAD><PAD><PAD><PAD>
<CLS>CCC1=C(C(=(S1)C(C)NS(=O)(=O)C2=CC=C(C=C2)Cl)C#N<SEP>CCCCCCCCCCCCCCCCCCCCCCCCCCCCCCCCCCCCCCCCCCCCCCCCCCC	<CLS>CCC1=C(C(=NS1)C(C)NS(=O)(=O)C2=CC=C(C=C2)Cl)C#C<SEP><PAD><PAD><PAD><PAD><PAD><PAD><PAD><PAD><PAD><PAD><PAD><PAD><PAD><PAD><PAD><PAD><PAD><PAD><PAD><PAD><PAD><PAD><PAD><PAD><PAD><PAD><PAD><PAD><PAD><PAD><PAD><PAD><PAD><PAD><PAD><PAD><PAD><PAD><PAD><PAD><PAD><PAD><PAD><PAD><PAD><PAD><PAD><PAD><PAD><PAD><PAD>
<CLS>CC(C1=CC=CC=C1)N(CC2=CC=CC=C2)C(C)N(C)(CC3=CC=CC=C3)C(=O)OC(C)(C)C<SEP>CCCCCCCCCCCCCCCCCCCCCCCCCCCCCCCC	<CLS>CC(C1=CC=CC=C1)N(CC2=CC=CC=C2)C(C)C(C)(CC3=CC=CC=C3)C(=O)OC(C)(C)C<SEP><PAD><PAD><PAD><PAD><PAD><PAD><PAD><PAD><PAD><PAD><PAD><PAD><PAD><PAD><PAD><PAD><PAD><PAD><PAD><PAD><PAD><PAD><PAD><PAD><PAD><PAD><PAD><PAD><PAD><PAD><PAD><PAD>
<CLS>CC1=CC2=NNC(=O)N2C3=CC(=C(C=C13)O)C4=CC=CC=C4C)N5CCCC5<SEP>CCCCCCCCCCCCCCCCCCCCCCCCCCCCCCCCCCCCCCCCCCCC	<CLS>CC1=CC2=NNC(=O)N2C3=CC(=C(C=C13)O)C4=CC=CC=C4CNC5CCCC5<SEP><PAD><PAD><PAD><PAD><PAD><PAD><PAD><PAD><PAD><PAD><PAD><PAD><PAD><PAD><PAD><PAD><PAD><PAD><PAD><PAD><PAD><PAD><PAD><PAD><PAD><PAD><PAD><PAD><PAD><PAD><PAD><PAD><PAD><PAD><PAD><PAD><PAD><PAD><PAD><PAD><PAD><PAD><PAD><PAD>
<CLS>CN(C)CC1(C(CCN1(C2=CC(=CC=C2)OCCO)(C3=CC(=CC=C3)OC)O.Cl<SEP>CCCCCCCCCCCCCCCCCCCCCCCCCCCCCCCCCCCCCCCCCCC	<CLS>CN(C)CC1CC(CCC1(C2=CC(=CC=C2)OC)O)(C3=CC(=CC=C3)OC)O.Cl<SEP><PAD><PAD><PAD><PAD><PAD><PAD><PAD><PAD><PAD><PAD><PAD><PAD><PAD><PAD><PAD><PAD><PAD><PAD><PAD><PAD><PAD><PAD><PAD><PAD><PAD><PAD><PAD><PAD><PAD><PAD><PAD><PAD><PAD><PAD><PAD><PAD><PAD><PAD><PAD><PAD><PAD><PAD><PAD>
<CLS>C1CC(OC1COC(C2=CC=CC=C2)(C3=CC=CC=C3)C4=CC=CC=C4)O<SEP>CCCCCCCCCCCCCCCCCCCCCCCCCCCCCCCCCCCCCCCCCCCCCCCC	<CLS>C1CC(OC1COC(C2=CC=CC=C2)(C3=CC=CC=C3)C4=CC=CC=C4)O<SEP><PAD><PAD><PAD><PAD><PAD><PAD><PAD><PAD><PAD><PAD><PAD><PAD><PAD><PAD><PAD><PAD><PAD><PAD><PAD><PAD><PAD><PAD><PAD><PAD><PAD><PAD><PAD><PAD><PAD><PAD><PAD><PAD><PAD><PAD><PAD><PAD><PAD><PAD><PAD><PAD><PAD><PAD><PAD><PAD><PAD><PAD><PAD><PAD>
<CLS>COC1=CC=CC=C1C(=O)NNS(=O)(=O)C2=CN=C(C=C2)Cl<SEP>CCCCCCCCCCCCCCCCCCCCCCCCCCCCCCCCCCCCCCCCCCCCCCCCCCCCCC	<CLS>COC1=CC=CC=C1C(=O)NNS(=O)(=O)C2=CN=C(C=C2)Cl<SEP><PAD><PAD><PAD><PAD><PAD><PAD><PAD><PAD><PAD><PAD><PAD><PAD><PAD><PAD><PAD><PAD><PAD><PAD><PAD><PAD><PAD><PAD><PAD><PAD><PAD><PAD><PAD><PAD><PAD><PAD><PAD><PAD><PAD><PAD><PAD><PAD><PAD><PAD><PAD><PAD><PAD><PAD><PAD><PAD><PAD><PAD><PAD><PAD><PAD><PAD><PAD><PAD><PAD><PAD>
<CLS>C1=CC(=C(C(=C1)Cl)C(=O)NC2=CC(=C(C=C2)F)F)F<SEP>CCCCCCCCCCCCCCCCCCCCCCCCCCCCCCCCCCCCCCCCCCCCCCCCCCCCCCC	<CLS>C1=CC(=C(C(=C1)Cl)C(=O)NC2=CC(=CC(=C2)F)F)F<SEP><PAD><PAD><PAD><PAD><PAD><PAD><PAD><PAD><PAD><PAD><PAD><PAD><PAD><PAD><PAD><PAD><PAD><PAD><PAD><PAD><PAD><PAD><PAD><PAD><PAD><PAD><PAD><PAD><PAD><PAD><PAD><PAD><PAD><PAD><PAD><PAD><PAD><PAD><PAD><PAD><PAD><PAD><PAD><PAD><PAD><PAD><PAD><PAD><PAD><PAD><PAD><PAD><PAD><PAD><PAD>
<CLS>CC1CC2=CC=CC=C2N1C(=O)CN3CCN(CC3)C(=O)C4=CC=CC=C4<SEP>CCCCCCCCCCCCCCCCCCCCCCCCCCCCCCCCCCCCCCCCCCCCCCCCC	<CLS>CC1CC2=CC=CC=C2N1C(=O)CN3CCN(CC3)C(=O)C4=CC=CC=C4<SEP><PAD><PAD><PAD><PAD><PAD><PAD><PAD><PAD><PAD><PAD><PAD><PAD><PAD><PAD><PAD><PAD><PAD><PAD><PAD><PAD><PAD><PAD><PAD><PAD><PAD><PAD><PAD><PAD><PAD><PAD><PAD><PAD><PAD><PAD><PAD><PAD><PAD><PAD><PAD><PAD><PAD><PAD><PAD><PAD><PAD><PAD><PAD><PAD><PAD>
<CLS>C1C2CC2C1C(CC3=CC=CC=C23)C(=O)O<SEP>CCCCCCCCCCCCCCCCCCCCCCCCCCCCCCCCCCCCCCCCCCCCCCCCCCCCCCCCCCCCCCCCCCC	<CLS>C1C=CC2C1C(NC3=CC=CC=C23)C(=O)O<SEP><PAD><PAD><PAD><PAD><PAD><PAD><PAD><PAD><PAD><PAD><PAD><PAD><PAD><PAD><PAD><PAD><PAD><PAD><PAD><PAD><PAD><PAD><PAD><PAD><PAD><PAD><PAD><PAD><PAD><PAD><PAD><PAD><PAD><PAD><PAD><PAD><PAD><PAD><PAD><PAD><PAD><PAD><PAD><PAD><PAD><PAD><PAD><PAD><PAD><PAD><PAD><PAD><PAD><PAD><PAD><PAD><PAD><PAD><PAD><PAD><PAD><PAD><PAD><PAD><PAD><PAD><PAD>
<CLS>COC1=CC=C(C=C1)NC(=O)NCC2=NN=C(N2C3=CC(=CC=C3)Cl)SCC(=O)NC4=NC=CS4<SEP>CCCCCCCCCCCCCCCCCCCCCCCCCCCCCCCC	<CLS>COC1=CC=C(C=C1)CC(=O)NCC2=NN=C(N2C3=CC(=CC=C3)Cl)SCC(=O)NC4=NC=CS4<SEP><PAD><PAD><PAD><PAD><PAD><PAD><PAD><PAD><PAD><PAD><PAD><PAD><PAD><PAD><PAD><PAD><PAD><PAD><PAD><PAD><PAD><PAD><PAD><PAD><PAD><PAD><PAD><PAD><PAD><PAD><PAD><PAD>
